还是	h;	2
出来	c;	2
但是	d;	2
发现	f;	2
工作	g;	2
不是	b;	2
自己	z;	2
一个	y;	2
现在	x;	2
我们	w;	2
这个	v;	2
他们	t;	2
什么	s;	2
如果	r;	2
起来	q;	2
朋友	p_
你们	n;	2
没有	m;	2
因为	l;	2
可以	k;	2
就是	j;	2
磐	pge
眬	lweuo
以	yb
做	zb
作	zv
不	b_
从	c_
的	d_
发	f_
过	g_
会	h_
就	j_
可	k_
了	l_
么	m_
你	n_
去	q_
人	r_
是	s_
他	t_
想	xm
者	vz
种	vh
头	tm
挺	ti
然	rm
劝	qb
难	na
两	lz
老	lc
拉	la
快	kz
看	kx
家	ja
很	hv
方	fz
这	v_
我	w_
下	x_
有	y_
在	z_
一	ye
个	gk
们	mk
中	vw
来	ly
上	sr
大	dp
为	wm
和	hf
国	gn
地	dy
到	du
说	sj
时	sg
要	yi
出	cc
也	yc
对	dz
生	sf
能	nz
而	rp
子	zc
那	nv
得	dg
于	yo
着	vm
自	zd
之	vj
年	nf
后	hg
里	lw
用	ys
道	dm
行	xg
所	sgu
事	si
成	cp
多	ds
经	jx
法	fe
学	xh
如	rb
都	di
同	tw
现	xo
当	dq
没	me
动	do
面	mp
起	qy
定	dh
天	to
分	fa
还	hp
进	jo
好	hb
小	xt
部	bl
其	qi
些	xr
主	vl
样	yd
理	lo
她	tb
本	bi
前	qm
开	ko
但	dk
因	yn
只	vn
实	sh
日	rg
军	jj
意	yl
无	wo
力	lb
它	th
与	yu
长	cf
机	jd
十	sii
民	mv
第	df
公	ga
此	cr
已	yv
工	gi
使	sk
情	qh
明	mg
性	xhu
知	vf
全	qk
三	so
又	yz
关	gm
点	dr
正	vi
业	yee
外	ws
将	jl
高	gl
间	jk
由	yw
问	wk
最	zg
重	vfe
并	bm
物	wf
手	su
应	ylo
战	vr
向	xd
文	wl
体	tk
政	viu
美	mm
相	xdi
见	jw
被	bj
利	lf
什	ske
二	ro
等	dfi
产	cl
或	hu
新	xl
己	jv
制	vfi
身	sd
果	gw
加	jb
西	xi
斯	siu
月	yr
话	hj
合	hk
回	hn
特	tf
代	dke
内	nw
信	xk
表	bo
化	hku
给	gx
世	sia
位	wko
次	clu
度	dl
门	mka
任	rk
常	cq
先	xf
海	he
通	tz
教	ji
儿	rs
原	yp
东	duo
声	sy
提	tu
立	ll
及	jbo
比	bu
员	yni
解	js
水	se
名	ms
真	viuo
论	lj
处	cs
走	zy
义	ym
各	gs
入	ra
几	jsa
口	kn
认	rj
条	ts
平	py
系	xs
气	qf
题	tg
活	heu
尔	rsi
更	gio
别	bn
打	due
女	nb
变	bla
四	sw
神	sji
总	zm
何	hke
电	dw
数	sm
安	rh
少	st
报	bua
才	ci
结	jxi
反	fg
受	sa
目	mw
太	tp
量	lg
再	zi
感	gp
建	jva
务	wsa
接	ju
必	bjo
场	cy
件	jku
计	jje
管	gf
期	qiu
市	sl
直	vii
德	dge
资	zl
命	mko
山	swi
金	jc
指	vu
克	ki
许	xj
统	tx
区	qu
保	bk
至	vui
队	dc
形	xou
社	sjiu
便	bke
空	kh
决	jla
治	ve
展	vv
马	mx
科	kf
司	sv
五	wi
基	jii
眼	ywa
书	sx
非	fr
则	zw
听	tn
白	bd
却	qya
界	jwi
达	dpo
光	gq
放	fl
强	qv
即	jvai
像	xku
且	qw
权	qd
思	swo
王	woe
象	xsi
完	wh
设	sju
式	sue
色	ss
路	ln
记	jja
南	ni
品	pn
住	vk
告	gfo
类	lm
求	qio
据	jua
程	cfo
北	br
边	bb
死	sp
张	vvu
该	gj
交	jlu
规	go
万	wu
取	qia
格	gd
望	wle
觉	jh
术	sdo
领	lk
共	giu
确	qp
传	ck
师	ste
观	gz
清	qe
今	jko
切	qua
院	yco
让	rji
识	sjo
候	hka
带	dii
导	dv
争	vs
运	yoo
笑	xfu
飞	fb
风	fs
步	bri
改	gv
收	sc
根	gda
干	goi
造	zf
言	yle
联	li
持	cu
组	zx
每	mf
济	je
车	cui
亲	ql
极	jdu
林	ld
服	fra
办	bbo
议	yj
往	wg
元	you
英	yt
士	sye
证	vje
近	jg
失	sfo
转	vue
夫	fo
令	lko
准	vli
布	bp
始	sb
怎	zfo
呢	nn
存	cpa
未	woo
远	yooa
叫	jn
台	tzo
单	dmi
影	yg
具	jwu
罗	lwu
字	zh
爱	rae
击	joi
流	le
备	bs
兵	bdu
连	lu
调	tj
深	seo
商	sli
算	sfi
质	vg
团	tne
集	jkuu
百	bpu
需	xy
价	jki
花	ht
党	dqu
华	hkei
城	cye
石	spo
级	jxu
整	vie
府	fli
离	lli
况	kl
亚	yie
请	qj
技	jue
际	jce
约	yx
示	soi
复	ff
病	ble
息	xdo
究	jhu
线	xx
似	ska
官	gh
火	hm
断	dmu
精	jm
满	mea
支	via
视	sjia
消	xe
越	yy
器	qn
容	rhu
照	vgo
须	xge
九	jsaa
增	zyo
研	ype
写	xje
称	cfu
企	qki
八	ba
功	gia
吗	mn
包	bsa
片	pd
史	swoo
委	wfa
乎	ha
查	cd
轻	quao
易	ygu
早	zge
曾	cm
除	cci
农	nj
找	vuea
装	vlo
广	glu
显	xgi
吧	bna
阿	rc
李	lda
标	bde
谈	tjo
吃	cn
图	tnu
念	nk
六	llu
引	yvi
历	lp
首	smu
医	yuu
局	jvao
突	the
专	vo
费	fv
号	hne
尽	jvo
另	lna
周	vsi
较	juo
注	veo
语	yje
仅	jka
考	kie
落	lt
青	qo
随	sce
选	xfo
列	lpi
武	woi
红	hx
响	xn
虽	sn
推	tui
势	sua
参	cz
希	xa
古	gioi
众	vki
构	gdu
房	fj
半	bmi
节	jt
土	ty
投	tuu
某	mi
案	rhuu
黑	hw
维	wx
革	gii
划	hui
敌	dfu
致	vuu
陈	cce
律	lga
足	zn
态	tpo
护	huo
七	quaa
兴	xhuo
派	pe
孩	hc
验	yxi
责	zo
营	yti
星	xgu
够	gsu
章	vle
音	ylu
跟	gna
志	vy
底	dlu
站	vlie
严	yiu
巴	bc
例	lke
防	fc
族	zlu
供	gke
效	xlu
续	xxe
施	slu
留	ls
讲	jjee
型	xoi
料	lmo
终	vx
答	dfio
紧	jea
黄	hi
绝	jxua
奇	qpe
察	ch
母	mxo
京	jlo
段	dd
依	yk
批	pu
群	qvo
项	xie
故	giue
按	ru
河	hee
米	mmo
围	wn
江	jee
织	vxo
害	hh
斗	dhe
双	sz
境	jy
客	khu
纪	jxa
采	ca
举	jhe
杀	sau
攻	giueo
父	fau
苏	sta
密	mh
低	dku
朝	ciu
友	ypa
诉	sjuu
止	vre
细	xxi
愿	ypo
千	qfi
值	vke
仍	rka
男	nwa
钱	qc
破	pp
网	ww
热	ruo
助	vwa
倒	dkea
育	ylua
属	svu
坐	zk
帝	dli
限	xc
船	cg
脸	lr
职	vio
速	sio
刻	kli
乐	lso
否	fp
刚	gwi
威	wp
毛	mfa
状	vleu
率	lla
甚	siuo
独	dsi
球	qoe
般	bg
普	pm
怕	ph
弹	dvo
校	xdoe
苦	kt
创	cki
假	jkae
久	jso
错	ccei
承	cco
印	ysa
晚	wgu
兰	lme
试	sje
股	gr
拿	nku
脑	nr
预	yze
谁	sjio
益	ymi
阳	ycu
若	rt
哪	nna
微	wgi
尼	nvu
继	jxo
送	smo
急	jsoa
血	xde
惊	jho
伤	sku
素	soa
药	yta
适	sfoa
波	be
夜	yli
省	sti
初	cj
喜	xyo
卫	wc
源	yeeu
食	sko
险	xci
待	dgi
述	sdoa
陆	lce
习	xz
置	vwe
居	jve
劳	lta
财	cw
环	ho
排	pui
福	fje
纳	nx
欢	hz
雷	lyi
警	jto
获	htu
模	md
充	clua
负	fsi
云	yoa
停	tko
木	mdo
游	yeo
龙	lpo
树	sda
疑	ysao
层	cv
冷	llio
洲	veou
冲	cli
射	sde
略	lwua
范	ft
竟	jlua
句	jsoi
室	she
异	yve
激	jeu
汉	hea
村	cde
哈	hni
策	cfe
演	yeoo
简	jf
卡	kr
罪	zwi
判	pmi
担	duu
州	vmi
静	jou
退	tv
既	jvea
衣	yloo
您	nko
宗	zhe
积	jfo
余	yke
痛	tl
检	jdi
差	cme
富	fh
灵	lv
协	xia
角	jsu
占	vro
配	pi
征	vge
修	xkua
皮	pb
挥	huoa
胜	sru
降	jcu
阶	jci
审	shi
沉	ce
坚	jei
善	smoi
妈	mb
刘	llii
读	dj
啊	rn
超	cya
免	msi
压	ypi
银	yca
买	ma
皇	hd
养	ymu
伊	yka
怀	hhe
执	vuua
副	fei
乱	lfa
抗	ku
犯	fsa
追	vd
帮	boi
宣	xhe
佛	fk
岁	swu
航	hgo
优	ykeu
怪	gha
香	xfui
著	vt
田	twe
铁	tc
控	kuo
税	sfou
左	zp
右	ypoi
份	fku
穿	che
艺	ytaa
背	bru
阵	vc
草	ct
脚	jr
概	gdae
恶	ri
块	ky
顿	dueu
敢	gvu
守	shei
酒	jeei
岛	dsia
央	ywo
托	tuue
户	hju
烈	lpoo
洋	yeou
哥	gie
索	siaa
胡	hiu
款	kyu
靠	kfi
评	pj
版	bduu
宝	bh
座	zli
释	saa
景	jgo
顾	gpe
弟	dma
登	dze
货	hki
互	hue
付	fke
伯	bku
慢	mhu
欧	ruu
换	huu
闻	wke
危	wsaa
忙	mho
核	hdo
暗	rgo
姐	jbi
介	jkui
坏	hy
讨	tje
丽	lei
良	ljo
序	xla
升	sfii
监	jeia
临	leu
亮	llua
露	lyo
永	yjo
呼	hnu
味	wne
野	ywao
架	jbu
域	yye
沙	sei
掉	dui
括	kuu
舰	jgi
鱼	ysi
杂	zs
误	wj
湾	we
吉	jyo
减	jle
编	bx
楚	cda
肯	kru
测	cei
败	bw
屋	wv
跑	pnu
梦	mdu
散	siue
温	weu
困	knu
剑	jkii
渐	jeea
封	fy
救	jiu
贵	gwia
枪	qdi
缺	qfa
楼	ldo
县	xw
尚	sq
毫	hl
移	yf
娘	nbo
朋	pr
画	hei
班	boo
智	vfu
亦	yloo;	2
耳	rie
恩	rno
短	dfe
掌	vq
恐	kio
遗	ywoa
固	gne
席	xli
松	sdu
秘	mfo
谢	xju
鲁	lsu
遇	ywoao
康	kla
虑	lro
幸	xyou
均	jyu
销	xcio
钟	vci
诗	sjiue
藏	cte
赶	gy
剧	jvi
票	pie
损	suo
忽	hs
巨	juae
炮	pmu
旧	jiui
端	dlia
探	tuo
湖	heei
录	lve
叶	yne
春	co
乡	xxu
附	fci
吸	xnu
予	yzi
礼	lja
港	ge
雨	yio
呀	ynea
板	bduua
庭	tlu
妇	fba
归	gt
睛	jwe
饭	fsu
额	rhe
含	hko
顺	sdeu
输	sui
摇	yuuo
招	vua
婚	hbu
脱	tr
补	bji
谓	wji
督	dri
毒	doa
油	yei
疗	llai
旅	llue
泽	ze
材	cdei
灭	meo
逐	vp
莫	mt
笔	bf
亡	wla
鲜	xso
词	cja
圣	szi
择	zu
寻	xv
厂	cpu
睡	swue
博	bie
勒	lia
烟	ymo
授	suu
诺	nja
伦	lki
岸	rw
奥	rd
唐	tla
卖	mio
俄	rku
炸	vmu
载	zie
洛	leua
健	jkaea
堂	tq
旁	pl
宫	gho
喝	hnui
借	jke
君	jvoi
禁	jde
阴	ycua
园	ynee
谋	mj
宋	shu
避	bv
抓	vuuu
荣	rtu
姑	gb
孙	sci
逃	ta
牙	yuuu
束	sioo
跳	tnuo
顶	die
玉	yooo
镇	vce
雪	xya
午	wfe
练	lx
爷	ya
迫	pdo
篇	pf
肉	rwi
嘴	zni
馆	gso
遍	bjoa
凡	fso
础	cpai
洞	de
卷	jma
坦	tyu
牛	nfi
宁	nh
纸	vxu
诸	vjei
训	xjui
私	sfa
庄	vliu
祖	zj
丝	sxe
翻	faa
暴	bge
森	sduu
塔	tya
默	mwe
握	wua
戏	xze
隐	ycuao
熟	slo
骨	gwu
访	fjo
弱	rv
蒙	mte
歌	giua
店	dlie
鬼	gdao
软	ruua
典	dwu
欲	yau
萨	stai
伙	hkou
遭	zio
盘	pg
爸	baa
扩	kuoe
盖	gmi
弄	no
雄	xp
稳	wfu
忘	wlo
亿	ykaa
刺	cii
拥	yuua
徒	tgi
姆	mba
杨	yda
齐	qlu
赛	shia
趣	qye
曲	qwe
刀	db
床	cluu
迎	yso
冰	bleo
虚	xri
玩	woee
析	xdu
窗	chu
醒	xiu
妻	quau
透	tfo
购	gwua
替	tou
塞	shiu
努	nba
休	xkuu
虎	hr
扬	yua
途	tkoa
侵	qka
刑	xoii
绿	lxa
兄	xnua
迅	xvo
套	tpe
贸	msia
毕	bue
唯	wni
谷	gao
轮	lui
库	kle
迹	jloa
尤	ypoo
竞	jloi
街	jgiu
促	cko
延	ydao
震	vye
弃	qle
甲	jwii
伟	wkee
麻	ml
川	cdi
申	swii
缓	hxu
潜	qee
闪	ski
售	skoi
灯	dme
针	vcei
哲	vuo
络	lxu
抵	duua
朱	vfo
埃	ry
抱	buu
鼓	gye
植	vde
纯	cx
夏	xpu
忍	rbo
页	ypia
杰	jdo
筑	vfei
折	vuuui
郑	vma
贝	bwi
尊	zme
吴	wnee
秀	xfa
混	heui
臣	cuia
雅	yui
振	vueu
染	re
盛	spi
怒	nboa
舞	wfua
圆	yno
搞	gu
狂	ks
措	cue
姓	xb
残	cpe
秋	qfo
培	pyo
迷	mmoa
诚	cje
宽	kha
宇	yh
猛	msa
摆	bui
梅	mdue
毁	hdu
伸	skia
摩	mlu
盟	mgi
末	mo
乃	nbu
悲	bro
拍	puu
丁	diii
赵	vyu
硬	ypei
麦	mou
蒋	jtoe
操	cuo
耶	yia
阻	zci
订	dje
彩	cau
抽	cuiae
赞	zfi
魔	mlui
纷	fx
沿	yeu
喊	hneu
违	wooa
妹	mbe
浪	leo
汇	heea
币	bdi
丰	foi
蓝	lti
殊	spu
献	xieu
桌	vru
啦	lne
瓦	wuo
莱	lte
援	yuuoe
译	yja
夺	dpe
汽	qeu
烧	sme
距	jne
裁	cio
偏	pk
符	ffi
勇	yza
触	csi
课	kj
敬	jtu
哭	kne
懂	dha
墙	qyei
召	vb
袭	xpo
罚	fw
侠	xke
厅	tpei
拜	buee
巧	qie
侧	ckia
韩	hie
冒	mwi
债	vkee
曼	mgia
融	rii
惯	ghaa
享	xlo
戴	diia
童	tli
犹	yse
乘	cfi
挂	gui
奖	jleu
绍	sxa
厚	hpu
纵	zxi
障	vco
讯	xja
涉	seie
彻	cge
刊	koi
丈	vpo
爆	bmu
乌	wse
役	ygua
描	mu
洗	xeu
玛	moa
患	hwo
妙	mbi
镜	jco
唱	cnu
烦	fm
签	qfio
仙	xki
彼	bga
弗	fvi
症	vlei
仿	fko
倾	qke
牌	pdu
陷	xcu
鸟	ns
轰	hua
咱	znu
菜	ctu
闭	bkei
奋	fpi
庆	qleu
撤	cuoe
泪	leia
茶	cti
疾	jlue
缘	yxa
播	buuo
朗	lju
杜	ddi
奶	nbau
季	jfa
丹	dse
狗	gsua
尾	wvu
仪	yko
偷	tki
奔	bpe
珠	vou
虫	cwo
驻	vxoe
孔	kc
宜	yhi
艾	rtuo
桥	qdu
淡	deo
翼	yzia
恨	hha
繁	ffa
寒	hho
伴	bko
叹	tna
旦	dgee
愈	ykoa
潮	cee
粮	lmoa
缩	sxo
罢	bwiu
聚	jiuio
径	jga
恰	qhi
挑	tuuo
袋	dko
灰	hpo
捕	buei
徐	xgie
珍	voi
幕	mti
映	ygi
裂	lpoe
泰	toe
隔	gc
启	qjo
尖	jte
忠	vwo
累	lwa
炎	ymou
暂	zuu
估	gkei
泛	feu
荒	hto
偿	ckio
横	hde
拒	juea
瑞	roi
忆	yha
孤	gcu
鼻	bdia
闹	nkoe
羊	ymii
呆	dn
厉	lpe
衡	hgu
胞	brua
零	lyio
穷	qha
舍	skee
码	mpa
赫	hyi
婆	pea
魂	hou
灾	zho
洪	heeiu
腿	tra
胆	dru
津	jeae
俗	skuo
辩	blo
胸	xru
晓	xgea
劲	jz
仁	rke
贫	pa
偶	rki
辑	juoi
邦	boa
恢	hheu
赖	liu
圈	qno
摸	mua
仰	yku
润	reo
堆	dyi
碰	ppo
艇	tgu
稍	sfio
迟	cvo
辆	lue
废	fla
净	jluaa
凶	xaa
署	swe
壁	bvi
御	ygue
奉	foe
旋	xlue
冬	dso
矿	kp
抬	tua
蛋	dci
晨	cgeu
伏	fkeu
吹	cnua
鸡	jzu
倍	bkoe
糊	hme
秦	qou
盾	dgei
杯	bdeu
租	zfia
骑	qx
乏	fao
隆	lcu
诊	vji
奴	nbao
摄	suei
丧	sioo;	2
污	wee
渡	deoe
旗	qlue
甘	giee
耐	np
凭	pku
扎	vuaa
抢	qui
绪	xxei
粗	cmi
肩	jju
梁	leuu
幻	hxa
菲	fti
皆	juu
碎	spoe
宙	vhi
叔	sra
岩	ywe
荡	dt
综	zxo
爬	pga
荷	hti
悉	xao
蒂	dto
返	fgo
井	joii
壮	vliue
薄	bt
悄	qhio
扫	suae
敏	mfu
碍	rpu
殖	vpe
详	xjo
迪	dwo
矛	mz
霍	hyio
允	yzu
幅	fwe
撒	sueiu
剩	sfiii
凯	kw
颗	kwe
骂	mna
赏	sqi
液	yeoe
番	fai
箱	xfuu
贴	twi
漫	meu
酸	siao
郎	ljai
腰	yre
舒	skao
眉	mc
忧	yhe
浮	feuo
辛	xle
恋	llo
餐	cri
吓	xne
励	lpa
辞	cfoe
艘	sgui
键	jca
伍	wkei
峰	fwu
尺	cvoo
昨	zgu
黎	lfi
辈	bre
贯	gxi
侦	vkie
滑	heia
券	qma
崇	cwoo
扰	rue
宪	xhue
绕	rx
趋	qyu
慈	cmo
乔	qfu
阅	ykou
汗	heee
枝	vdei
拖	tuuea
墨	mwiu
胁	xra
插	cuu
箭	jfou
腊	lre
泥	ne
粉	fmu
氏	ssa
彭	pyu
拔	bueu
骗	px
凤	fsao
慧	hoo
媒	mbei
佩	pkua
愤	fhe
扑	puio
龄	lri
驱	qxe
惜	xhei
掩	yue
豪	hle
兼	jmo
跃	ynu
尸	svuu
肃	svo
帕	pw
驶	sxi
堡	bki
届	jvia
欣	xgua
惠	hio
册	cse
储	ckoa
飘	piu
桑	szu
闲	xkuuo
惨	cha
洁	jeiu
踪	zno
勃	bia
宾	bhu
频	pre
仇	cku
磨	mle
递	dmo
邪	xua
撞	vuoe
拟	nu
滚	geo
奏	zoe
巡	xxo
颜	yleu
剂	jli
绩	jxe
贡	giia
疯	flu
坡	pya
瞧	qwi
截	jiio
燃	rmu
焦	jkoo
殿	dvu
伪	wkou
柳	ldu
锁	scio
逼	bio
颇	pbe
昏	hsu
呈	cne
搜	suui
勤	qiau
戒	jueu
驾	jba
漂	pee
饮	ysu
曹	ciui
朵	dsu
仔	zka
柔	rz
俩	lkei
孟	mci
腐	flia
幼	yxau
践	jnee
籍	jfe
牧	mfue
凉	lloe
牲	sfu
佳	jkiu
娜	nbae
浓	neo
芳	fto
稿	gfoe
竹	vfue
腹	fru
跌	dnu
逻	lwo
垂	cfee
遵	zmo
脉	mr
貌	mau
柏	bdui
狱	ysoa
猜	csee
怜	lh
惑	huoao
陶	tcu
兽	smeo
帐	vwu
饰	ssu
贷	dki
昌	cgu
叙	xka
躺	td
钢	gci
沟	geu
寄	jheu
扶	fu
铺	pc
邓	dza
寿	soe
惧	jhi
询	xjua
汤	te
盗	dliae
肥	frai
尝	cqe
匆	cso
辉	hq
奈	npe
扣	kuoi
廷	tfa
澳	reu
嘛	mno
董	dtu
迁	qfoa
凝	nl
慰	wvo
厌	ypeu
脏	zr
腾	tro
幽	ywaa
怨	ysoao
鞋	xii
丢	dfa
埋	my
泉	qde
涌	yea
辖	xuo
躲	ddu
晋	jiuie
紫	zra
艰	jza
魏	wfui
吾	wio
慌	hhau
祝	vjo
邮	ywai
吐	tni
狠	hsa
鉴	jeie
曰	yge
械	xdea
咬	ynoe
邻	lka
赤	cyu
挤	juoe
弯	wlae
椅	yde
陪	pco
割	ghi
揭	juui
韦	woii
悟	whe
聪	ciou
雾	wy
锋	fcu
梯	tdo
祥	xjou
猫	msau
阔	kk
誉	yho
筹	cfeee
丛	cke
牵	qpu
鸣	mnu
沈	seoa
阁	gku
穆	mfui
屈	qva
旨	vsu
袖	xji
猎	lse
臂	bvu
蛇	swoou
贺	hbi
柱	vdo
抛	puua
鼠	sdao
瑟	soo
戈	guo
牢	lhu
逊	xco
迈	muo
欺	qiua
吨	dne
琴	qoi
衰	slia
瓶	pme
恼	nho
燕	yioi
仲	vkia
诱	yju
狼	lsoa
池	cea
疼	tlua
卢	lra
仗	vkeu
冠	gje
粒	lmoe
遥	yao
吕	lno
玄	xlaa
尘	ctiu
冯	flaa
抚	fue
浅	qeee
敦	dlue
纠	jxai
钻	zcie
晶	jgu
岂	qwa
峡	xwe
苍	ctia
喷	pne
耗	houe
凌	lliu
敲	qli
菌	jtoi
赔	pwo
涂	tei
粹	cmoe
扁	bjia
亏	koa
寂	jhie
煤	mme
熊	xzo
恭	giio
湿	seu
循	xguu
暖	ng
糖	tmo
赋	fwee
抑	yuuaa
秩	vfueo
帽	mwia
哀	rl
宿	shie
踏	tneo
烂	lmou
袁	yyo
侯	hkae
抖	duoo
夹	jyoo
昆	kg
肝	gre
擦	cuoo
猪	vse
炼	lmea
恒	hheui
慎	sheiu
搬	buuu
纽	nxa
纹	wxo
玻	boau
渔	yeua
磁	cpo
铜	tci
齿	cria
跨	kneu
押	yuia
怖	bhe
漠	meau
疲	pla
叛	pmuu
遣	qwo
兹	zma
祭	jse
醉	zioe
拳	qmu
弥	mvu
斜	xko
档	ddio
稀	xfuo
捷	jueao
肤	fre
肿	vri
疫	yluaa
豆	deoi
削	xq
岗	gwiau
晃	hgi
吞	too
宏	hheua
癌	rlo
肚	driu
隶	lvo
履	lvu
涨	vea
耀	yq
扭	nua
坛	tye
沃	weue
拨	buau
绘	hxi
伐	fkea
堪	kye
仆	pki
郭	gla
牺	xfe
歼	jp
墓	mtiu
雇	gji
廉	llou
契	qoeu
拼	puo
惩	cgo
捉	vuoi
覆	fi
刷	svi
劫	jya
嫌	xbo
瓜	gg
歇	xguai
雕	dsio
闷	mkoa
乳	raa
串	cwi
娃	wb
缴	jxui
唤	hnua
赢	ylia
莲	ltea
桃	tdu
霸	by
妥	taa
瘦	slui
搭	dua
赴	fyi
岳	ydi
嘉	jyau
舱	cgi
俊	jkao
址	vyi
庞	ple
耕	goe
锐	rco
缝	fxu
悔	hhu
邀	ydo
玲	loi
惟	whi
斥	cgoo
宅	vhu
添	tee
挖	wuoo
呵	hnei
讼	sjuo
氧	yfo
浩	heue
羽	yzao
斤	jgii
酷	kiu
掠	luo
妖	ybu
祸	hjo
侍	skiu
乙	yaa
妨	fbo
贪	tkia
挣	vuuaa
汪	weee
尿	nve
莉	ltu
悬	xwo
唇	cpoi
翰	hii
仓	cka
轨	guu
枚	mdueo
盐	yyi
览	leiau
傅	fkei
帅	stia
庙	mli
芬	ftu
屏	pv
寺	syei
胖	pro
璃	loo
愚	ywoao;	2
滴	deoei
疏	sco
萧	xta
姿	zla
颤	cle
丑	ccee
劣	ltau
柯	kd
寸	cioo
扔	rua
盯	dwe
辱	rpe
匹	puuaa
俱	jkia
辨	blou
饿	rsu
蜂	fwua
哦	rnu
腔	qr
郁	ypai
溃	ke
谨	jjei
糟	zmei
葛	gtu
苗	mtia
肠	cra
忌	jvoa
溜	leuai
鸿	heeiua
爵	jaa
鹏	pru
鹰	yluae
笼	lfe
丘	qdee
桂	gdi
滋	zeo
聊	liua
挡	duio
纲	gxia
肌	jru
茨	cto
壳	kyua
痕	hla
碗	wpo
穴	xhuoo
膀	broe
卓	vrei
贤	xei
卧	wii
膜	mra
毅	yluaao
欠	qs
锦	jcui
哩	lni
函	hca
茫	mteo
昂	rgu
薛	xtu
皱	vsa
夸	kpe
豫	yzua
胃	wwu
舌	sfoi
剥	bvii
傲	rkee
拾	suio
窝	who
睁	vwua
携	xui
陵	lci
哼	hno
棉	mdui
晴	qg
铃	lcio
填	tyei
饲	ssae
吻	wnu
渴	keu
扮	buuoa
逆	nm
脆	cru
喘	cni
罩	vwi
卜	bq
炉	lmoau
柴	cruu
愉	yhiu
胎	trao
绳	sxoi
蓄	xto
眠	mwa
竭	jlui
喂	wnia
傻	skui
慕	mtio
浑	heo
奸	jbe
扇	sja
柜	gde
悦	yhou
拦	luou
诞	dju
饱	bsu
乾	qiue
泡	peu
贼	zwe
亭	tle
夕	xsoo
爹	da
酬	cioui
儒	rkeo
姻	ybo
卵	lsa
氛	ffu
泄	xee
杆	gdee
挨	ruao
僧	skou
蜜	mhi
吟	ynio
猩	xsu
遂	smoa
狭	xse
肖	xqu
甜	tfe
霞	xyae
驳	bxu
裕	yjuo
顽	woeu
於	ylio
摘	vuoei
矮	rf
秒	mfi
卿	qsa
畜	clia
咽	ynoi
披	pua
辅	fuei
勾	gsa
盆	pai
疆	jvei
赌	dwei
塑	smi
畏	wwe
吵	cniu
囊	nio
嗯	rnoi
泊	beu
肺	frei
骤	vxe
缠	cxo
冈	gwuo
羞	xma
瞪	dwa
吊	dni
贾	jiia
漏	lea
斑	booe
涛	teee
悠	ykoao
鹿	lle
俘	fkuo
锡	xcui
卑	bdei
葬	zt
铭	mcu
滩	tea
嫁	jboo
催	ckiai
璇	xoo
翅	cia
盒	hkia
蛮	mlia
矣	yzue
潘	peuo
歧	qre
赐	cwu
锅	gco
鲍	bsua
廊	lloa
拆	cuuu
灌	gea
勉	msauu
盲	mliae
宰	zhoe
佐	zke
啥	sni
胀	vrue
扯	cuie
禧	xjiu
辽	lco
抹	mue
筒	tfi
棋	qdei
裤	kjo
唉	rna
朴	pdi
咐	fn
孕	yba
誓	suoe
喉	hnia
妄	wlau
拘	juua
链	lcea
驰	cxa
栏	ldou
逝	suoa
窃	qhe
艳	youa
纤	xxue
臭	cdeu
玑	joua
棵	kdi
趁	cyi
匠	juuu
盈	ybi
翁	wa
愁	cfoa
瞬	swuo
婴	ywau
孝	xiai
颈	jze
倘	tkio
浙	vee
谅	ljoe
蔽	bto
畅	cwa
赠	zwo
妮	nbaeu
莎	steo
尉	wve
冻	dle
跪	gnu
闯	ckaa
葡	pt
後	hga
鸭	ywu
厨	cpei
颠	dieu
遮	vloa
谊	yjoo
圳	vyui
吁	xnee
仑	lku
辟	pvo
瘤	lluai
嫂	sbu
陀	tco
框	kde
谭	tjei
亨	hlo
钦	qcu
庸	yla
歉	qmua
芝	vto
吼	hna
甫	fio
衫	sjuuu
宴	yhu
摊	tuao
嘱	vna
衷	vlia
娇	jbue
陕	sceo
矩	jfea
浦	peei
讶	yjea
耸	skei
裸	lji
碧	boe
摧	cuiai
薪	xtoe
淋	leuuu
耻	ciie
胶	jro
屠	tve
鹅	rfu
饥	jsua
盼	pwu
脖	brei
虹	hwe
翠	czo
崩	bwu
账	vwue
萍	pte
逢	fsoa
赚	vwou
撑	cuio
翔	xmao
倡	ckui
绵	mxu
枯	kdei
猴	hsi
巫	wiii
昭	vga
怔	vhe
渊	yeuo
凑	clee
溪	xeuo
蠢	coi
禅	cjo
阐	ckou
旺	wge
寓	yhia
藤	tt
伞	skoui
匪	fui
碑	bpui
挪	nuae
琼	qoo
脂	vrua
谎	hja
慨	khae
菩	pto
萄	ttu
狮	ssi
掘	juaea
抄	cuiu
岭	lwi
晕	ygea
砍	kpu
逮	dvoa
掏	tuua
狄	dsou
晰	xguuu
罕	hje
挽	wuu
脾	prui
舟	vgoo
痴	clue
蔡	ctua
剪	jmau
脊	jluae
弓	gva
懒	lhe
叉	czoo
拐	guoi
喃	nne
僚	lkeu
捐	juoiu
姊	zbu
骚	sxao
拓	tue
歪	wpe
粘	vmie
柄	bdeio
坑	kyo
陌	mce
窄	vhue
湘	xeuu
兆	va
崖	yweu
骄	jxue
刹	cai
鞭	bii
芒	mto
筋	jfu
聘	pii
钩	gcua
棍	gdui
嚷	rnoe
腺	xrui
弦	xvoe
焰	ymua
耍	spa
俯	fkoe
厘	lpia
愣	lhi
厦	spe
恳	kv
饶	rse
钉	dce
寡	ghe
憾	hheuo
摔	suoea
叠	dzi
惹	rto
喻	yniu
谱	pjo
愧	khui
煌	hmu
徽	hgia
溶	reoo
坠	vciu
煞	sso
巾	jwii;	2
滥	leii
洒	see
堵	dye
瓷	clea
咒	vnu
姨	ybe
棒	bdee
郡	jvaii
浴	yeuoo
媚	mbai
稣	ssue
淮	heio
哎	rnau
屁	pve
漆	qeuu
淫	yeuou
巢	cxi
吩	fnu
撰	vuae
啸	xna
滞	veei
玫	moue
硕	speu
钓	dcu
蝶	dweiu
膝	xruu
姚	ybuo
茂	mteu
躯	qdea
吏	lio
猿	ysiu
寨	vhee
恕	sbo
渠	qeuuo
戚	qpi
辰	cpee
舶	bgu
颁	bae
惶	hhui
狐	hsuu
讽	fju
笨	bfe
袍	pju
嘲	cnei
泼	peau
啡	fni
衔	xgiee
倦	jkou
涵	heai
雀	qt
旬	xsui
撕	sueiuu
僵	jkei
肢	vreia
垄	lpiu
夷	yuo
逸	ysoao;	2
茅	mta
侨	qku
舆	ydu
窑	yhue
涅	neu
蒲	pteo
谦	qjou
杭	hdoe
噢	rnui
弊	bme
勋	xnau
刮	gfi
郊	jlai
凄	qlea
捧	pue
浸	jeaea
砖	vpee
鼎	dwae
篮	lfii
蒸	vta
亩	mliae;	2
饼	bso
肾	seua
陡	dciu
爪	vgoo;	2
兔	tso
殷	yguaa
贞	vria
荐	jteu
哑	ynei
炭	tweu
坟	fyo
眨	vwuo
搏	bueie
拢	lueu
咳	kno
舅	jdia
昧	mge
擅	suoeo
爽	spuo
咖	kna
搁	guoiu
禄	ljae
雌	crio
哨	snio
巩	giuao
绢	jxoi
螺	lwia
裹	gli
昔	xiui
轩	xue
谬	mja
谍	djei
龟	gsi
媳	xbu
姜	jmaue
瞎	xwoo
冤	yjua
鸦	yuuae
蓬	ptu
巷	xiae
琳	lou
栽	ziu
沾	vei
诈	vju
斋	vleui
瞒	mwau
彪	bruu
厄	rpa
咨	zlo
纺	fxo
罐	gfa
桶	tda
壤	ryo
颂	sae
糕	gmo
膨	pri
谐	xjea
垒	lzi
咕	gnei
隙	xciu
辣	llei
绑	bxe
宠	cheu
嘿	hniao
兑	dmoi
霉	myu
挫	cuii
稽	jfeu
辐	fueo
乞	qfaa
纱	sxiu
裙	qja
嘻	xni
哇	wniu
绣	xxuea
杖	vdeu
塘	tyo
衍	ygeo
轴	vuia
攀	pde
膊	breie
譬	pvoe
斌	blee
祈	qju
踢	tnui
肆	siae
坎	kyuai
轿	juue
泣	qeo
棚	pdua
屡	lvou
躁	znoi
邱	qda
凰	hsui
溢	yeoui
椎	vdi
砸	zpe
趟	tyi
帘	lhia
帆	fwuao
栖	qdeie
窜	chi
丸	wso
斩	vuuui;	2
堤	dyu
塌	tyui
贩	fwuu
厢	xpuu
掀	xuu
喀	knoo
乖	gfie
谜	mjo
捏	nuu
阎	ykua
虏	lrau
滨	beo
匙	cgua
芦	lto
苹	pteoi
卸	xfai
沼	veau
钥	ycuae
株	vdu
祷	djee
剖	pli
熙	xio
怯	qhiu
哗	hnie
劈	pva
棠	tqu
胳	gru
桩	vdoe
瑰	gou
娱	yboi
娶	qiaue
沫	mee
嗓	sna
蹲	dno
淘	teu
焚	fd
嫩	nbe
韵	yluao
匈	xsuo
衬	cjei
竖	seoe
钧	jcua
峻	jwa
豹	bau
捞	lua
菊	jtua
鄙	bnai
魄	pdui
兜	ddua
哄	hneiu
颖	yseu
镑	bco
屑	xvi
蚁	ywou
壶	hyii
怡	yhao
渗	sea
秃	tfu
迦	jboa
旱	hge
哟	yna
咸	xpe
焉	yiea
宛	whu
谴	qji
稻	dfuo
铸	vcee
锻	dcui
伽	jkau
詹	vso
毙	bueuu
恍	hhi
贬	bwuo
烛	vmia
骇	hxo
芯	xtoa
汁	veeii
桓	hdeu
坊	fyoe
驴	lxo
朽	xdeaa
靖	jlee
佣	ykuai
汝	rea
碌	lpae
迄	qfoao
冀	jri
荆	jti
崔	cwio
雁	ypii
绅	sxia
珊	sou
榜	bdo
诵	sjao
傍	bkoeo
彦	yluu
醇	cioe
笛	dfia
禽	qko
勿	wsu
娟	jboi
瞄	mwaui
幢	vwoe
寇	khe
贿	hweu
睹	dweiui
踩	cnuo
霆	tyue
呜	wnua
拱	gue
妃	fbae
蔑	mtiae
谕	yji
缚	fxe
诡	gju
淹	yeeui
篷	pfu
腕	wr
煮	vioo
倩	qkee
卒	zlie
勘	kia
馨	xyu
逗	dio
甸	dsiae
贱	jwee
炒	cmiu
灿	cmia
敞	cqu
蜡	lwe
囚	qni
栗	liuu
辜	gioe
垫	duiu
妒	dbo
魁	kdo
谣	yjuou
寞	mha
甩	ssaa
蜀	swua
枕	vdoa
涯	yeeuiu
丐	giaa
泳	yeoa
奎	kpi
泌	meoa
逾	ykoao;	2
叮	dnei
黛	dkia
燥	zmoi
掷	vuou
枢	sdea
憎	zhou
藉	jtee
鲸	jsoe
弘	hva
倚	ykeue
侮	wku
藩	fte
拂	fua
鹤	hjua
蚀	ssia
芙	ftee
浆	jleo
垃	lyoe
烤	km
晒	sge
霜	syu
剿	jxii
蕴	ytaau
圾	jyua
屿	ywea
绸	cxu
氢	qfao
驼	txo
妆	vla
捆	kuoiu
铅	qcua
逛	gsoa
淑	seiea
榴	ldua
丙	bioo
痒	ylou
钞	cciu
蹄	tno
犬	qpo
躬	gdaea
昼	vvui
藻	zte
蛛	vwueo
褐	hjui
颊	jye
奠	dmeu
募	mtau
耽	dioa
蹈	dnuo
陋	lcei
侣	lkoi
魅	mde
岚	lwuau
侄	vkea
虐	nre
堕	dciue
陛	bce
莹	yte
荫	ytai
狡	jsoeu
阀	fki
绞	jxoe
垮	kyeu
膏	glua
茎	jta
缅	mxe
喇	lnei
绒	rxe
搅	juoo
凳	dzu
梭	sdaou
丫	ymii;	2
姬	jbea
诏	vja
钮	nc
棺	gdo
耿	giou
缔	dx
懈	xhua
嫉	jboe
灶	zmi
匀	ysoe
嗣	snae
鸽	gkua
澡	zeoi
凿	zeou
纬	wxe
沸	fea
刃	rboo
畴	cwe
遏	rgoa
烁	smua
嗅	xnui
叭	bnu
熬	roo
瞥	pmia
骸	hwoe
奢	spei
拙	vuai
栋	dde
毯	tfou
桐	tdi
砂	spiu
泻	xeo
莽	mteue
坪	pye
梳	sdoe
杉	sduuu
晤	wgei
稚	vfio
蔬	staio
蝇	ywoi
顷	que
捣	duuai
麽	mlua
尴	gpi
镖	bcei
尬	gpiu
诧	cjoo
硫	lpoeu
羡	xmo
嚼	jnu
沦	leiu
沪	heoa
旷	kgo
彬	bduuu
芽	ytea
狸	lsi
冥	mju
碳	tpi
咧	lneu
惕	thu
暑	sgei
萝	ltia
咯	lnu
汹	xeuoa
腥	xruiu
窥	khee
俺	rkeu
潭	teei
崎	qweu
麟	llouu
捡	jui
拯	vuaie
厥	jpo
澄	ceao
哉	zioi
萎	wt
涡	weo
滔	teuo
暇	xga
溯	seou
鳞	lsou
酿	nioa
茵	yto
愕	rho
暮	mtiae;	2
瞅	cwue
衙	ygei
诫	jjea
斧	fauu
兮	xae
焕	hmua
棕	zdo
佑	ykeuo
嘶	sne
妓	jbei
喧	xno
蓉	rtoo
删	ssii
樱	ydia
伺	skae
嗡	wnuo
娥	rbu
梢	sdi
坝	byi
蚕	coia
敷	fiu
澜	leoi
杏	xdoi
绥	sxu
冶	ylao
庇	blea
挠	nue
搂	ldoua
倏	skua
聂	nia
婉	wbo
噪	znoiu
稼	jfoo
鳍	qse
菱	ltiu
盏	voia
匿	nuau
吱	vne
寝	qho
揽	luii
髓	sweu
秉	bfo
矢	sfe
哺	bne
帜	vwoi
啪	pnei
邵	sba
挟	xueo
嗽	snei
缸	gfe
揉	ruaou
腻	nrea
驯	xxui
缆	lxi
晌	sguio
瘫	tlao
贮	vwoo
觅	mai
朦	mrau
隋	sceu
僻	pka
蔓	mtu
咋	znue
嵌	qwei
虔	qro
畔	pwou
琐	soio
碟	dpei
涩	seau
胧	lreu
嘟	dneia
蹦	bni
冢	vjeu
浏	leoe
裔	yliau
襟	jjuu
叨	tnau
旭	xsuie
诀	jjae
虾	xwei
簿	bfeo
啤	pnui
擒	quio
枣	zioo
嘎	gneu
苑	ytu
牟	mzu
呕	rne
骆	lxua
凸	tre
熄	xmu
兀	wpa
喔	rnae
裳	sqo
凹	rwe
赎	swei
屯	tuaa
膛	tri
浇	jeeae
灼	vmua
裘	qioe
砰	ppe
棘	jie
橡	xdua
聋	lpei
碱	jpe
姥	lbe
瑜	yoi
毋	wxee
娅	ybei
沮	jeiae
俏	qkio
萌	mtui
黯	rwo
粟	siou
撇	puou
粪	fme
尹	yvu
苟	gtua
癫	dlei
蚂	mwaa
禹	ydoo
廖	llao
俭	jkio
帖	twie
煎	jmoo
缕	lxou
窦	dhei
簇	cfoeu
棱	ldi
叩	knai
呐	nni
瑶	youo
莺	ytua
墅	swiu
烫	teo
蛙	wwi
歹	dpoo
伶	lkio
葱	ctuao
哮	xnei
眩	xwoe
坤	kyi
廓	klo
讳	hjee
啼	tnoe
乍	vfee
瓣	blu
矫	jfue
枉	wd
跋	bneu
梗	gdei
厕	cpi
琢	voe
讥	jjua
釉	yai
窟	khaea
敛	lkue
轼	suea
庐	lloau
胚	preu
呻	snia
绰	cxie
扼	rueu
懿	yyoe
炯	jmi
竿	gfee
慷	kho
虞	yro
锤	ccu
栓	sdie
桨	jluu
蚊	wwo
磅	bpo
孽	nt
惭	chea
戳	cze
禀	bloi
鄂	rnai
馈	ksi
垣	yyeu
溅	jeiaee
咚	dnua
钙	gce
礁	jpi
彰	vlu
眯	mwo
豁	hhuo
磷	lpou
雯	wyo
墟	xyi
迂	yooao
瞻	vwuao
颅	lreui
琉	looe
悼	dhi
蝴	hwei
拣	jueao;	2
渺	mei
眷	jmia
悯	mhoi
汰	teeu
慑	sheia
婶	sboo
斐	fro
嘘	xnie
镶	xcoe
炕	kmo
宦	hhea
趴	pnuo
绷	bxua
窘	jha
襄	xloi
珀	po
嚣	xneu
拚	puao
酌	viua
浊	veia
毓	yfoe
嗜	sneiu
撼	hueu
扛	kue
峭	qwio
翘	quaoa
磕	kpiu
槽	cdeiu
栅	vdua
淌	teio
颓	tfeu
熏	xfoo
瑛	yoau
忖	chei
颐	yueu
牡	mfiu
缀	vxa
徊	hgoi
梨	lfu
肪	froe
涕	teou
惫	bsoa
摹	mtue
踱	dnoe
肘	vreio
挚	vuue
熔	rmo
氯	lfae
绎	yxao
凛	lloeo
庶	sloo
脯	prei
迭	dfo
睦	mwiuu
窍	qhei
粥	vvo
庵	rle
沧	ceia
沁	qeoa
怠	dzo
奕	yleuo
咙	lneuo
氨	rfo
矗	cie
盔	kpia
拇	muaa
沛	peeii
榻	tdui
揣	cuiaeu
崭	vwea
鞘	qii
鞠	jiua
垦	kvi
洽	qei
唾	tnue
橱	cdeue
仕	skiue
蜘	vwueoi
痰	tlo
袜	wje
峙	vwiu
柬	jio
蝉	cwou
蟹	xsia
谏	jjeio
鹃	jnua
擎	qtu
皓	hdue
朕	vrou
疤	blai
禺	ywoo
铲	ccoe
酶	miu
钝	dcea
匣	xuia
氓	mla
弧	hvu
峨	rwu
锥	vcio
揪	juueo
杠	gdeie
吭	knoe
崛	jwae
诬	wjei
冉	rwee
抒	suao
庚	glae
悍	hhuie
靡	mlie
晦	hgue
醋	ciei
夭	yfoo
锯	jcae
壕	hyo
咦	yneao
侈	ckua
婢	bbu
猾	hsia
徘	pgi
硝	xpi
煽	smoaa
皂	zde
舵	dgo
嗦	sneia
狈	bsi
靴	xiiu
捂	wue
疮	cliaa
郝	hya
苛	kte
秽	hfi
茜	qte
搓	cuou
芸	ytee
赁	lkia
酱	jlei
檐	ydua
饷	xsuio
蕉	jtio
铀	yci
苔	tta
赦	syue
缎	dxu
舷	xgo
筷	kfo
朔	smuae
婪	ldau
紊	wlaa
厮	speiu
婿	xba
寥	lha
兢	jiei
糙	cmu
卦	gyi
槐	hdui
扒	buuoo
裴	proe
祀	sjae
埔	pyei
絮	xbaa
芭	bta
屉	tvei
痪	hlu
霄	xyio
绽	vxoo
邑	ynai
宵	xhi
霖	lyu
岔	caia
茄	qta
饵	rsei
韧	roa
琪	qoei
邹	zsa
瑚	hoe
憋	bmo
殆	dpa
噜	lnua
忒	tuoa
忿	faoa
衅	xdou
淳	ceo
悖	bhei
髦	miue
孜	zcu
粤	ydea
隘	rcou
濒	bei
铮	vcu
畸	jweu
剔	tgii
坞	wyu
篱	lfo
淀	deoo
蓦	mtaa
唬	hnieu
趾	vni
锣	lcia
汀	teeii
缉	jxoie
嫦	cb
斟	viooe
鞍	rio
扳	buuua
拴	suie
诅	zji
谟	mjau
呃	rneu
懦	nhe
逞	cno
犁	lfue
忏	chue
拧	nuo
亥	hloo
叱	cnuaa
佟	tku
舜	saua
绊	bxo
龚	gpei
腮	sri
邸	dsa
椒	jdie
蔚	wta
狩	ssoo
湛	veeiu
眶	kwea
栈	vdee
薇	wtu
肮	rr
瀑	peui
渣	veu
褂	gjiu
叽	jnuaa
臀	tvu
妞	nbai
巍	wwue
唔	rnei
疚	jluao
戎	rueuo
鲤	lsia
肇	vjae
笃	dfaa
辙	vuoeu
娴	xboi
札	vda
阮	rce
懊	rhui
焘	tooo
恤	xhui
疹	vliuu
潇	xea
铝	lcoi
涤	deu
恃	shiue
喽	lnou
砌	qpea
遁	dgoa
楞	ldia
阱	jcee
咎	jsoie
洼	wei
炳	bmei
噬	snu
枫	fdu
拷	kuei
哆	dnuau
矶	jpu
苇	wte
翩	pja
窒	vhea
侬	nkoa
胰	yrea
靶	biai
芜	wtee
嚎	hnoe
辫	blaa
妾	qla
幌	hwu
踉	lnoa
佃	dkiae
葫	hte
拽	vuiau
皖	wdo
滤	leie
睬	cwuo
匕	bsaa
俞	ykuaii
谤	bjoe
嗤	cna
捍	huui
孵	fsuo
倪	nkui
瘾	ylai
匡	kuee
敝	bmue
绫	lxiu
磋	cpou
尧	yueua
淆	xeuoe
蕊	rtoa
烘	hmei
璋	voo
亢	klu
轧	yuaa
赂	lwuao
榆	ydiu
蝗	hwui
骏	jxao
诛	vjue
勺	ssoo;	2
梵	fdua
炽	cmoi
笠	lfoe
颌	hkeu
闸	vkiai
狒	fsae
樊	fde
镕	rcoo
垢	gyu
瘟	wlu
缪	mxa
菇	gta
琦	qoeue
剃	tmi
炫	xmoe
溺	nea
迸	bmoa
惚	hhua
嗨	hneo
陨	ycoi
赃	zwoe
羁	jwei
嘀	dnoei
臻	vuee
膳	sro
赣	gluae
殉	xpua
踌	cnee
桔	jdiu
瞿	qwioe
闽	mki
豚	treu
掺	cua
沌	dee
喳	vnuu
惰	dheu
椭	tdai
咪	mnou
霎	syo
侃	kko
猝	csoe
窖	jhue
戮	lze
祠	cjae
瞩	vwae
菁	jteeu
佬	lkeiu
躇	cnau
肋	lrauu
咄	dna
忡	chia
雍	ylaa
忱	cho
蕾	lteo
跄	qnia
硅	gpiui
伎	jkeia
炊	cmua
钊	vcii
蝠	fweo
拭	sueae
屎	svou
谛	djo
褪	tja
丞	ccee;	2
卉	hieu
隧	scou
茸	rte
钳	qce
啃	kni
伢	ykea
闺	gki
舔	tfee
蹬	dnao
挛	lluei
眺	twu
袱	fji
陇	lceu
殴	ruuaa
柿	sdoei
梧	wde
惺	xhuiu
弛	cva
侥	jkea
琛	coo
捅	tuaoi
酝	yiee
薯	stiae
曳	ywuu
澈	ceoe
锈	xcue
稠	cfua
眸	mwao
咆	pnua
簧	hfe
鸥	ruuae
疡	ylau
渎	deei
汲	jeua
嬉	xbi
脓	nro
骡	lxia
穗	sfei
巳	sva
拎	luio
槛	kdii
邢	xoa
廿	nie
搀	cuua
曙	sgi
樵	qdio
隅	ycia
筛	sfiu
谒	yjui
倭	wkue
痹	bli
猖	csu
佯	ykoui
肛	grei
奚	xaaa
抨	pueo
甭	bpua
蛾	rwue
唠	lnau
荧	ytou
嵩	swoe
漱	seei
诘	jji
酋	qme
攘	ruoe
篡	cfia
睿	rri
噩	rioi
怅	chueo
徙	xgiei
盎	rwia
鞅	yii
祟	scee
漓	leoei
睫	jwea
攸	ykue
翎	lkao
呛	qniaa
筐	kfe
檀	tdoe
堑	quiu
寅	yhei
磊	lpeu
驭	yxaoo
惘	whia
吠	fne
驮	txe
瑙	noa
炬	jme
痉	jlao
曝	pgu
恺	khi
萤	ytia
胺	rro
敕	ciue
筝	vfua
幡	fwuo
霹	pyae
竺	vfeee
烙	lmu
毗	pwe
鸠	jsuae
埠	byu
蒜	stee
阜	fdei
嘈	cneiu
乒	pduu
帷	wwio
啄	vneu
鳌	rou
毡	vfie
阙	qkou
褥	rje
搔	suaoi
笋	sfae
狞	nso
冕	mgu
韶	sla
骼	gwuao
蔼	rtoau
烹	plo
奄	ypiaa
嫖	pbei
沐	meuu
噗	pni
岑	cwioa
蛟	jwo
咏	ynoa
弩	nbaea
掳	luie
圃	pneie
捻	nui
孚	faai
悴	choe
呱	gnuu
诣	yjuau
祁	qjai
钠	nci
捶	cuue
袄	rju
澎	pei
氮	dfou
恪	khua
雏	csio
堰	yyea
撮	cuui
唆	snao
彷	fgoe
晖	hgoa
犀	xve
沽	gee
橄	gdaeu
腑	froei
掐	quu
亵	xlei
龋	qru
嗒	dnau
咀	jni
祺	qje
匾	buo
锚	mca
乓	pdoo
贻	ywaoo
萃	ctoe
揖	yuoi
觑	qri
吝	lloi
憔	qhioo
羌	qmaa
诲	hjue
砾	lpu
蠕	rweo
肴	yae
撩	lueuu
坍	tyua
酥	siueo
袅	nsoe
黝	ywaaa
俾	bkui
嫣	ybeie
穹	qhae
秧	yfi
妊	rbue
溉	geae
鹊	qiuae
聿	yvii
疙	glue
蘑	mtoe
睾	gdiu
楷	kdea
锌	xcoee
酵	jieia
茹	rta
滇	deeiu
辗	nuaee
纂	zfiae
圭	gyiu
幔	mwu
褒	bliu
揍	zue
倔	jkaeai
诽	fjie
颉	jyeu
腓	fri
锄	ccia
嗔	cneiuo
磺	hpe
攒	zuue
雳	lye
瘩	dla
吆	ynaa
悚	sheio
墩	dyo
彝	yxo
囱	cdu
逍	xqo
辄	vuei
俨	ykei
桅	wdu
纶	lxiua
殃	ypiao
悸	jhuea
帧	vwie
俐	lkuei
绮	qxeu
籽	zmai
袒	tju
孰	slua
愫	shee
拌	buou
橙	cdao
暨	jvu
赘	voiai
敖	roue
抉	juaeo
淤	yeoei
剌	lii
娼	cbu
顼	xoe
葵	kta
哝	nno
酣	hiei
麓	ldoe
琅	looa
钵	bceie
簸	bfei
禾	hfo
铢	vcue
璧	bve
娠	sbe
彗	hoa
惋	whoo
腋	yroe
螂	lwoa
阪	bcu
劾	hlau
掣	cfue
沥	lee
粱	leou
嚓	cnoo
惮	dho
氖	nfa
捎	suiou
羔	gmoo
俟	skaou
渲	xeoo
榄	ldii
茧	jtia
霓	ny
鹉	wou
胥	xcua
撬	quue
橘	jda
琶	poa
拈	nuie
笆	bfa
痊	qlie
亟	jcee;	2
渭	weia
狙	jsi
珂	koe
刨	ps
蜕	two
谚	yjoe
憧	choei
瞟	pwei
拗	nuaa
馒	msu
帚	vvi
钗	cca
哧	cniuu
喋	dneiu
箫	xfae
刁	dve
怦	phe
缭	lxe
迥	jwoa
湄	meai
渝	yeiu
把	bz
冗	rjua
闵	mkoe
噶	gnau
黏	nfie
蕃	btu
驿	yxaoe
弼	bveu
淄	zea
饺	jsoeuo
韬	touo
硪	wpu
心	xu
鹦	ywua
蜒	ywui
偎	wki
榨	vdoo
漉	leoee
皈	gduu
矜	jzi
碉	dpu
笈	jfua
鲨	seuai
枷	jdau
蹑	nnei
瀚	heeii
酪	liuao
谑	xjie
癖	plae
揩	kuea
炙	vsou
烬	jmae
蜷	qwou
侏	vku
凋	dlua
漪	yeuae
悻	xhiu
蹋	tnuia
讪	sjiai
碘	dpi
搐	cuoei
帛	bdiai
诠	qjie
碾	npa
擂	lueo
苯	bte
诃	hjei
铎	dca
戊	wpoo
荀	xtua
驹	jxuao
攫	juia
憬	jhui
哽	gneio
踵	vnue
蟒	mwaue
漾	yeouo
啧	zne
吮	snaou
氟	ffae
楠	nd
怂	skoa
叼	dnae
竣	jlaou
偕	xkea
漩	xeoe
蹭	cnou
翌	yzo
挝	wuei
臆	yroeo
绚	xxua
崽	zwia
糜	mlo
瘢	bluu
跤	jno
恬	thue
阑	lkeio
豢	hmeu
跷	qne
汶	weoe
琵	poe
蜗	wwoi
憨	hvo
螅	xwu
惴	vhia
戟	jiea
匮	kui
恙	ymoa
抿	muae
桢	vdie
笺	jfee
蛤	hwi
瞳	twoe
瓢	piuu
芹	qtuu
秤	cfeo
跺	dnuauu
潦	leeu
哒	dneu
饬	csue
栩	xda
曦	xgou
骷	kwei
卤	lroi
鬓	bioou
丕	ppee
嫡	dboe
梓	zdoe
嗖	snui
惦	dhoe
浚	jeao
咔	knie
藐	mtuo
荃	qti
唧	jnae
玺	xsee
汛	xeae
铐	kce
髅	lwou
皿	mwee
渤	bee
箍	gfei
馅	xsua
戍	spoo
汾	feuoa
痔	vliuei
褶	vjao
聆	liio
汞	gieo
涎	xeui
巅	dweie
奂	hsiao
疣	yleuo;	2
渍	zee
逵	kyoa
傩	nka
耆	qiui
蟋	xwuo
鳄	rso
讹	rjiu
膺	yluae;	2
蹿	cnooi
筏	ffie
沂	yeuu
釜	fae
坯	pyeu
峦	llia
茬	cteu
蟀	swoea
摒	buae
撵	nuee
缤	bxoo
浒	heoau
珑	loe
嵋	mwai
苞	btua
瑾	joe
泵	bpeo
钾	jcia
暧	rguo
赓	glia
叟	sdaoo
佚	ykueo
沓	teui
撂	luia
甥	sfia
晏	ygo
蛊	gwiae
璐	looi
瘪	blui
漳	veoe
阉	ykeui
蹂	rnao
琏	loea
鳃	ssiao
湃	peue
辘	luoe
躏	lnauo
僭	jkeau
鼾	hdee
懵	mhau
镰	lcoe
寐	mhai
褚	vjeiu
攥	zuuei
涧	jeo
蝙	bwo
脐	qroe
辕	yuiu
涣	heua
杞	qdae
煜	ymui
骥	jxie
祯	vjie
傣	dkee
嗳	rnuo
酉	yiee;	2
捺	nueu
秸	jfi
瑕	xoae
鑫	xcie
馋	csua
窿	lhai
胱	gri
楔	xdee
荔	ltaua
蟆	mwauu
屹	ywue
轲	kueio
湍	teia
遐	xvoa
镯	vcia
缰	jxei
桦	hdi
炖	dmea
羚	lmi
诩	xjao
钡	bci
啬	sioi
绯	fxi
掖	yuoe
箓	lfaee
涸	heoi
鸳	ysua
塾	sliu
呸	pneu
抡	luiu
擞	suou
坷	kyei
跛	bnau
亘	geui
瓮	wae
嗟	jnou
筵	yfu
汕	seia
欤	yuuai
壑	hri
颍	yseui
姗	sbua
溥	peeie
踊	ynao
枭	xsuu
跚	snua
暄	xgoo
稷	jfia
笙	sfue
涟	leea
瀛	yeoea
踝	hniao;	2
滕	trou
贰	ruee
瞰	kwa
恻	chiai
嚏	tnei
迢	tboa
獗	jseu
邯	hia
睑	jwio
赡	swuao
珥	roe
萦	ytaai
酮	tii
璞	poi
羹	gmou
缄	jxeu
晾	lgo
俸	fkee
鸾	lluae
媲	pbu
恿	yzoa
蜿	wwoo
蜈	wwoie
讷	nji
扈	hjoi
犊	dfei
戌	xpeo
藕	rtee
蓓	bti
翟	vzi
鋆	yyie
谀	yjue
谩	mjui
卯	msai
岐	qweia
谙	rjo
蝎	xwui
荼	tti
椰	ydei
镀	dco
甄	viea
蹊	xnuo
蟾	cwua
泞	neoo
螃	pwoe
撸	luu
檬	mda
猓	gsia
蔷	qtei
羲	xmue
瘸	qlau
蘸	vte
蔗	vtoe
傀	kku
蚌	bwe
锢	gcoi
恚	hyoa
遽	jroa
邃	sho
皑	rdi
锵	qco
簌	sfeiu
昊	hgee
焙	bmoe
鹳	gtuae
睽	kwao
刽	gkii
鳖	bmeia
呗	bnia
噎	yniue
寰	hhia
唷	ynoeu
殡	bpoo
睐	lweo
诰	gjue
恣	zloa
淖	nei
婵	cbo
榈	ldoi
氦	hfoe
靳	jiuu
蛹	ywaoi
鸯	ywuae
惬	qhea
蹙	cpoii
诙	hjeu
眈	dwoa
罡	gwe
胤	yuaaa
缮	sxou
蛀	vwoee
皋	gdeu
偌	rkau
绛	jxuae
疵	clie
葆	btio
黔	qwioa
喙	hnaa
佼	jkoe
烽	fmua
斓	lloie
儡	lkiai
嫔	pbo
龈	yra
颚	rneui
盅	vwia
娓	wba
坂	byuu
町	dweii
芥	jtiu
瘠	jloe
挎	kueu
荟	htie
阂	hkoe
啜	cnao
橇	qdue
垛	dyua
淇	qeei
瓒	zou
篓	lfou
虱	saui
跻	jnoe
龛	kke
髯	riia
蹒	pna
痫	xloiu
瞠	cwioi
掂	duoe
酰	xiue
镁	mco
潼	teoe
灸	jsou
腆	tria
筱	xfi
谆	vjoe
壬	rfe
茗	mtua
骋	cxia
椋	ldoeo
蛔	hwoi
潺	ceae
扉	fjiei
耘	yoe
槟	bdoo
雹	byua
甬	yziai
淞	seuu
谥	sjou
蚪	dwoo
蕙	htei
燎	lmeu
蜻	qwee
轶	yuue
郸	dmai
狰	vsua
楣	mdai
荪	staii
捋	luuo
涓	jeoi
娄	lma
麝	sluie
蚤	zz
薰	xtue
醮	jiioo
搪	tuoe
辍	cuao
湮	yeei
谧	mjoa
瞌	kwi
茉	mtee
梆	bdeea
樟	vdoeu
岖	qwea
臼	jdee
癣	xlua
穑	sfeio
玷	doi
馍	msauui
呷	xnia
妩	wbe
萼	rtoi
伫	vko
彤	tsu
岬	jwia
莓	mtuea
媛	ybuoe
惆	chua
鳎	tsui
蜓	twue
啾	jnue
囔	nneio
孺	rceo
徇	xguau
徵	vgi
焊	hmui
岱	dkiai
昵	nga
卅	spii
邙	mlai
飙	bpuau
隼	skeii
痞	pleu
恫	dhia
怆	chiaa
桀	jsuu
绶	sxuo
裆	dji
盂	yoia
桧	gdie
蚓	ywae
抠	kueau
槌	cdui
嗷	rnee
蚣	gwuoa
痘	dleo
痢	llueii
芮	rti
闩	skee;	2
铿	kci
飓	jsia
蝌	kwu
疱	plu
蚯	qwu
撅	jueuo
窠	khia
斡	wiio
荚	jteo
耷	dpeie
砚	ypiau
牒	ddei
赈	vweu
煦	xgooo
嗫	nneia
耙	poai
榕	rdo
鞑	dieuo
袤	mlao
谌	cjeiu
醺	xiueo
秆	gfeei
徨	hgui
翡	frao
橹	lduau
缨	yxia
锹	qcue
嵇	jfeui
圪	gyue
髻	jiiu
嗬	hnau
辎	zua
痣	vliuo
谄	cju
娩	mbu
蛐	qwia
鹞	yaua
翱	rda
庖	plua
籁	lfei
蓿	xtoo
鳗	msui
疟	nle
鲇	nsi
颔	hkeui
嚅	rneo
黜	cwai
黠	xwi
瘀	yloe
濑	leei
馁	nsu
忐	troa
洵	xeua
忑	tio
砥	dpua
咂	znea
罹	lwoo
糠	kmoe
匝	zui
偃	ykeau
淙	ceoo
纫	rxa
闾	lkoio
祛	qjiu
喏	rnaue
蛰	vuiao
腼	mre
涝	leau
曜	yga
闰	rkeee
洄	heoio
疽	jlia
厩	jpa
煊	xmoo
汐	xeuao
铬	gcuao
璜	hoei
藓	xtuao
渥	wea
靼	diu
酗	xiuo
苓	ltio
噤	jnuu
咫	vvoi
椿	cdee
鲫	jsae
罔	wwou
锭	dcoo
锺	vcuee
匍	pse
祗	vjua
锰	mcai
岌	jwua
畹	wwoou
馀	ycie
糯	nme
胫	jra
銮	llie
熠	yma
沅	yeee
旌	jlueu
棣	dda
豌	wioo
孢	bcua
盹	dwea
驸	fxie
腌	yreu
熵	smoe
镭	lceo
镐	gcoe
馐	xsou
骰	twua
嘤	ynia
癞	lleiu
韭	jre
阖	hkiu
裨	pjui
瞑	mwoa
宕	dheuo
戾	lje
镌	jciau
隽	jkauu
牍	ddeio
溟	meoau
婊	bbe
鹄	hfu
拄	vuoee
埂	gyei
虬	qwaa
娲	wboi
萱	xtooe
啵	bneo
蠡	lxiai
芋	yteei
胭	yroi
豺	cae
啻	clo
褛	ljou
蛆	qwiae
柠	ndo
掰	buuou
篆	vfa
咛	nnoo
倌	gko
蛭	vweai
纭	yxe
荨	xtae
莞	wto
谡	sjiau
澹	deua
潞	leoiu
郅	vuaii
弋	yuoo
飕	ssui
螳	twio
胄	vwuae
蟑	vwoeu
昙	tge
宓	mhoa
锏	jcoi
猥	wsi
蟠	pwuo
柑	gdeie;	2
匐	fse
烯	xmuo
濮	peii
蟮	swou
仄	zpi
偈	jkuiu
蜃	spia
粼	lmaa
箴	vfeu
嗥	hnuie
褴	ljii
蕨	jteuo
圩	wye
蓟	jtuai
杳	ydui
孪	llaie
魇	ypu
荤	htea
诿	wju
簪	zfe
氲	yfui
飒	sluau
摞	luiaa
镂	lcou
舀	yaui
夙	sse
臧	zpea
貂	daa
蒿	htoe
蜥	xwuu
蹩	bmoi
钛	tce
噼	pnae
钚	bceu
铠	kcia
皙	xdui
鲈	lsie
濂	leoeo
霭	ryoa
獾	hsau
叵	puoi
霾	myuo
泯	meae
鸵	tsoo
碴	cpuu
峪	ywuo
饕	tnio
睢	swio
瘁	cloe
纣	vxei
迩	rsoa
鬃	ziooe
夔	kmu
饨	tse
垠	yya
榭	xduie
娑	seaue
隍	hcu
篝	gfeeia
榔	ldoa
洌	leeui
浜	beui
鲑	gsiu
汩	geuie
舐	sfua
浣	heoo
谔	rjoi
瞭	lweu
忻	xhuu
咻	xniu
唑	znii
鹑	cluae
皎	jdoe
懋	mdoa
诒	yjao
麾	hlue
辏	cuee
氐	dsoo
冽	lleu
箕	jfei
俚	lkiae
汴	beoe
宸	cheue
芍	stu
捱	rueue
摈	buoo
摺	vuao
簦	dfao
咝	snaa
箔	bfeou
孀	sbeo
怏	yhiao
谝	pjoa
耄	miuea
砧	vpi
罂	ywuei
漕	ceei
馕	nse
沣	fee
栾	lluu
烷	wmo
榘	jfuu
沱	teoo
俑	ykao
缜	vxeiu
榷	qdo
鹫	jluae;	2
蛳	swiue
泗	seiae
剽	piii
衢	qgi
臊	sroi
瘴	vloe
纾	sxaoi
晁	cguo
酚	fiuo
孛	biaie
炀	ymau
叁	sze
憩	qfoao;	2
掬	juuao
椤	ldiau
啮	nnie
畿	jxia
骁	xxea
掸	duou
镣	lceuu
侗	dkiaei
椽	cdaa
泓	heae
荩	jtae
蚱	vwuee
酯	viuau
滦	leoeu
癜	dlae
癸	gze
扪	muoi
庑	wlee
蚜	yweau
歆	xluai
蝮	fwue
蹶	jneu
弈	yleui
庋	gle
喟	knia
滂	peo
蛎	lweue
啕	tnua
翊	ylaoa
槁	gdoe
龊	cro
獭	tsei
邺	yeai
莘	sto
燮	xlao
铛	dcio
剁	dsii
觐	jiiau
谗	cjua
镍	ncu
臃	yroea
墒	syoe
燔	fmuo
晔	ygie
涿	veeu
嘭	pniu
醯	xioe
箩	lfia
睨	nwu
鄱	paa
坳	rya
诤	vjuaa
砷	spiai
鹭	lnuae
唏	xnuoe
猬	wsia
殁	mpu
蚩	cciao
琥	hoi
伲	nkae
泾	jeaoe
缥	pxe
殓	lpio
鳅	qsu
刍	csa
芷	vti
诋	djua
逅	hgoao
舫	fgoeu
氰	qfe
嶙	lwouu
呓	ynau
唰	snaei
茁	vtai
妫	gbo
馑	jsei
骧	xxoe
苷	gte
峋	xwua
袂	mjae
擢	vuaoi
懑	meoao
蓑	stoe
祉	vjiee
涞	leeo
踹	cnia
沏	qeea
诳	kju
饽	bse
掇	duao
噫	ynoeo
饪	rsue
绺	lxuao
谘	zjo
飧	ssio
迳	jzo
铡	vciai
枞	cdii
熨	yvo
鋈	weie
荭	hta
俦	ckee
戛	jpea
赊	swie
幺	yxoo
湎	meeu
芪	qtua
凇	sluu
觯	vsoui
龌	wra
苻	ftie
挞	tueu
嘁	qneu
嬴	ylauo
鞯	jia
肽	treuo
恸	thee
迨	dzoa
钰	yce
儆	jkauue
讫	qjue
觎	yki
滓	zeoo
媾	gbe
龇	zri
僮	tkoe
涮	seae
杈	cdaoo
赳	jyai
胯	kre
疸	dlui
斛	hso
绾	wxoo
觥	gsio
卞	bloo
愠	yhui
拮	juiu
庠	xlou
烨	ymie
菠	bteo
窈	yhaa
罄	qyue
囤	tnea
弁	bze
咣	gni
奘	zce
腴	yru
缫	sxaa
缈	mxi
柚	ydiae
喵	mnau
遛	lsoao
潢	heeiia
郏	jyaii
荻	dtua
琨	kou
藜	ltue
镳	bcoe
雉	vfioe
橐	tie
艮	gvo
骈	pxo
蛉	lwio
柩	jdea
搽	cuau
寮	lheu
濡	ree
佗	tkoo
啷	lnoaa
诜	sjue
偻	lkou
夯	hpa
闱	wkeei
枸	gdua
虻	mwoe
谖	xjuo
筠	yfiu
膑	broo
夥	hwua
臾	ydoo;	2
埽	sya
笞	cfa
婀	rba
珞	loua
粑	bma
怵	chuu
崂	lwau
觊	jwiau
殒	ypoii
绻	qxo
昱	ygoe
嗑	kniu
榛	vdeeu
颧	qteu
蜴	ywuiu
鳝	ssou
噙	qnio
淼	meeo
矾	fpu
囿	yneu
硼	ppu
泅	qeoi
邂	xsoa
蠹	diiai
钜	jcea
垩	riiu
乩	jraa
淦	gei
嗝	gneo
樽	zdou
诮	qjio
啐	cnoe
淅	xeuuu
揆	kua
榉	jdoo
馗	kso
鱿	yseuo
骛	wz
辔	pxoi
暹	xgoa
犷	gsoe
苫	stie
詈	lwoe
竦	sle
獠	lseu
诨	hjoa
篙	gfoeo
峒	twia
铰	jcoe
馄	hsuie
滢	yeau
蜚	fria
靓	loia
琬	wooo
犟	jvue
璨	coie
狻	ssao
鸬	lru
螨	mwauei
嘹	lneuu
芩	qtio
蜇	vuiao;	2
锟	kcu
栉	vdau
洹	heeu
钍	tciu
俪	lkeia
瑁	moi
锨	xcuu
壹	yyeo
竑	hleu
痿	wlue
粕	pmui
犄	jfeue
瘙	slao
抟	tuee
饯	jsee
衲	njia
龅	bruaa
踮	dnoeie
愎	bhue
馥	ffue
梏	gdue
讣	fjio
艿	nta
邝	klai
趺	fnee
鲟	xsa
绉	vxua
剜	whii
笥	sfaeo
罅	xfie
衩	cjao
斫	vpu
姣	jboeu
鹗	rnua
爻	yauo
晗	hgio
铩	scu
猕	msae
窕	thuo
仨	skeee
酢	ciuee
崴	wweu
搡	suaou
佞	nke
璀	coiai
檄	xduiu
舛	csea
岷	mwae
闿	kki
邕	yxoi
铂	bcui
霁	jyoe
犒	kfoe
馏	lsua
阈	ykeao
麋	mlou
麒	qlei
苁	ctii
妍	ybee
宥	yheu
涔	ceiai
铤	tcue
摁	ruoi
锷	rcoi
恽	yhoa
嗲	dnuou
麂	jluaa;	2
胛	jria
赝	ypiai
哂	sneie
呶	nnau
栎	lduao
桎	vdea
飨	xxio
撷	xuiu
噘	jneuo
霰	xye
懔	lho
娣	dbou
揄	yuiua
噔	dnaoe
忝	toi
咤	vno
薏	ytoe
迤	yfoa
泸	leiea
贲	biia
胪	lrie
嗵	tnao
鍪	mzi
刈	yaii
咿	yniae
鹌	rpua
蔫	nte
僖	xkiu
嗪	qnee
茏	lteu
岫	xwia
茯	ftieu
轱	guei
怼	dzoao
铨	qci
嵘	rwa
昕	xguui
郢	ynaii
咩	mnoui
馊	ssuia
髡	kieu
澧	leiae
苣	jtea
盥	gdia
濯	veao
囡	nnaue
砺	lpeue
佘	skeei
弑	saea
楂	vduu
谶	cji
翦	jmao
怩	nha
楹	ydau
霏	fyie
蠼	qwiai
讴	rjea
锲	qcee
砭	bpuo
胝	vruao
慵	yhoe
杵	cdue
潍	weaa
樾	ydiue
帼	gwo
碣	jpui
诌	vjuaae
钴	gcei
徕	lge
胴	dria
啶	dnoo
裟	seoeo
铣	xcueu
铱	ycoe
楫	jdoi
赭	vyei
酊	diei
碛	qpee
醛	qiaui
魑	cdo
陂	bca
剐	gnii
阄	jkua
畦	qwiu
闶	kkoe
祚	zju
鹘	hwuae
泱	yeia
骅	hxie
陲	ccue
趄	qyi
呤	lnio
郧	ynaii;	2
铉	xcoea
倜	tkua
燧	smou
粲	crou
骶	dwua
忸	nhai
峁	mwua
渌	leae
戡	kiea
骞	qhaa
髭	zii
苋	xti
钨	wcu
锃	zco
蜊	lwue
谲	jjao
戕	qcea
闼	tke
骊	lxei
幄	wwa
虢	gai
妲	dbu
绌	cxai
烩	hmi
袈	jboeo
傥	tkiou
桠	ydeie
肓	hlua
杲	ggu
揿	quie
薮	stou
莅	ltioe
厝	cpeiu
氤	yfoi
缙	jxeiu
诟	gjuu
衮	gluo
硒	xpei
旖	ylue
唁	ynoee
硎	xpee
裱	bje
嬗	sboe
颦	pruie
纥	gxu
煨	wmi
靥	ypeue
鏖	rli
礴	bpa
羿	yzeu
笏	hfua
蝈	gwoi
炜	wme
笕	jfiau
锉	ccii
湟	heuie
煲	bkou
鼐	nbi
甑	zmea
妪	ybea
浔	xeaee
弭	mve
喑	ynoeui
锂	lciae
嶂	vwoeui
苡	ytao
颏	kleu
孳	zmaie
醴	liia
轭	rueua
蚝	cwuea
渚	veeiui
鹬	yzuae
邛	qiai
覃	tiu
痨	llau
褡	dja
耦	roia
膘	breiee
馔	vsae
篾	mfia
兖	yluo
爰	yaee
痂	jlau
阋	xkui
遨	rooa
艄	sgio
耨	noe
沤	reea
昶	cjui
秣	mfe
焓	hmio
邋	lxoa
俎	zki
绦	txu
窣	shiuo
榫	sdiei
蟪	hweio
烃	tma
氩	yfe
稗	bfu
锴	kcea
龉	yrei
謇	jhoe
鸢	yuuae;	2
肱	greu
俣	ykoi
痤	clii
嬷	mbo
笫	zfu
芨	jtuao
莆	ptei
砣	tpoo
菏	hteo
阕	qkao
碜	cpao
鼹	yduio
竽	yfee
舸	gge
猷	yme
诓	kje
錾	zuie
姘	pbou
悌	tho
淬	ceoei
隗	wcui
婕	jbeao
槭	qdeu
邈	mao
歙	skuai
蹴	cnoee
稹	vfeiu
豕	spoo;	2
砒	ppea
痈	yluai
鲂	fsoe
镏	lcua
羯	jmu
匦	guea
笤	tfau
蓖	btui
峥	vwuaa
浃	jeeo
烊	ymoui
徭	yguo
蚨	fweeo
趔	lyeu
缢	yxou
褓	bjio
窸	xhuooa
翳	yuao
酆	foa
誊	tmoe
仃	dkei
炔	qmae
泷	leeuo
勖	xwa
蚴	ywaaau
葺	qto
蛴	qwoe
赜	zuee
媸	cba
茑	ntu
诖	gjiui
祜	hjeio
俳	pkie
逡	qz
孱	cvai
跸	bnea
砦	vreu
伉	kkoeu
屐	jvuu
蛞	kwue
溴	xeuie
飚	bsou
圻	qyuu
矸	gpee
鸨	bsuae
掮	quo
崆	kwo
庾	ylui
缂	kxe
蒯	kti
橛	jdeu
饧	tsa
鸪	giuae
诹	zje
啭	vnea
蛩	qiia
镉	gceo
蠖	hwa
劭	sbau
杼	vdao
哐	knea
棂	ldae
遑	hdoa
龃	jriae
螫	vyia
颢	hgeu
饔	ylioa
崧	swuu
腱	jrae
襁	qjae
牝	pfua
忾	khue
蛄	gwei
鲆	pseo
濠	heoe
嗄	rneuu
灏	heuieu
苜	mtiae'	3
荞	qtue
疥	jliu
砝	fpiu
嘣	bniau
夤	ysoo
颞	nieu
忤	whue
旎	nlu
辇	noea
遢	tgo
瘛	cleeo
魉	lde
瓤	rlu
氚	cfui
荥	xte
娌	lbi
涫	geoo
毂	gyua
碇	dpooe
臁	lroe
吡	bneau
玮	woeei
毖	buoa
羟	qmao
缛	rxeu
壅	yliu
珈	joa
虼	gwue
颀	qge
佝	gkuao
祇	qjua
珏	joee
郛	faaii
翕	xkao
遴	lmoao
玖	jouao
诂	gjei
逋	bioa
粽	zmoo
氅	cque
蹇	jhoi
岢	kweio
聒	giueoi
髁	kwia
芾	ftei
闳	hkeua
淝	feua
黍	sfie
鲎	hhuae
鞣	ria
髋	kwoo
潆	yeaua
汨	meui
胍	gruu
钤	qcio
铵	rcooa
阏	rko
戬	jieao
鹜	wzu
鬈	qiou
枰	pdeo
衾	qkoe
脍	kri
崮	gwoie
畲	skiae
樯	qdeio
蹼	pnii
囫	hnuae
劬	qsau
洱	reei
咭	jniu
刎	wsii
碚	bpoe
鳕	xseo
芏	dti
琊	yoea
芎	xtaea
绀	gxe
恂	xhuau
谪	vjoei
嘧	mnoo
槿	jdei
鲢	lsea
鲧	gsuai
郦	liai
浠	xeuoeu
跏	jnau
潸	seuuu
噱	xniee
鲶	nsio
苌	ctue
抻	cuiai;	2
臬	ndu
琰	yoou
鹚	cmuae
矍	jwiao
龆	trau
芄	wtua
呔	tneu
觞	ssuea
雒	lsio
饫	ysue
钒	fcua
鸩	vjuae
舂	cou
阒	qkia
槎	cdou
阡	qcuei
妗	jbio
莒	jtoio
蚧	jwiu
萸	ytui
谠	djio
稔	rfi
餍	ypio
穰	rfoe
芗	xtaa
葩	ptui
谯	qjioo
踔	cnie
菸	ytoeu
饩	xsue
钏	ccui
佻	tkuo
倨	jkaee
嘌	pneiee
蠓	mwauee
黩	dweio
厣	ypiai;	2
钿	dcia
恁	nkoao
殚	dpou
缬	xxiu
鎏	leiee
藿	hteoi
囟	xduo
呋	fneeo
瓯	ruea
旃	vlue
绱	sxio
婺	wza
酩	miua
锶	scia
鄣	vlai
恹	yheue
鸹	gfu
逶	wfo
缦	mxui
讦	jjeei
邬	wsai
殇	spue
菟	ttua
媪	rbui
阗	tkei
鲛	jsoeuo;	2
篑	kfia
螟	mwoau
濉	seiai
醪	liao
芡	qtuai
肼	jree
峤	jwue
嫠	loeu
鄯	sma
讧	hjeie
岘	xwiau
掼	gua
焖	mmoi
愆	qgo
聩	kii
矽	xpuao
卟	bnio
姒	sbao
杷	pda
挈	qoue
蚋	rwiao
袢	pjou
菖	ctui
笳	jfau
靛	doo
砉	hoeu
黾	mni
踽	jnui
凫	fsua
侩	kkie
诔	ljee
莜	ytiu
郯	tmai
笪	dfui
挲	seue
鼋	yooi
韪	wgee
趿	tnuao
菅	jtoo
裢	ljea
嵊	swuei
箸	vfeiui
旯	lgu
莴	wtoi
莠	ytue
涪	feo
赍	jiiai
圜	hniae
阌	wkuo
囵	lniu
柞	zdu
曷	hgua
笾	bfau
跎	tnoo
巽	xvei
嗍	sno
裰	djao
榧	fdea
簟	dfeiu
讵	jjeaa
枋	fdo
绔	kxeu
逖	tsoa
骓	vxi
魃	bdeua
镒	ycou
餮	tpio
乜	mxaa
鄢	yiai
瑭	tooe
踅	xuoi
馓	ssei
蟛	pwi
鳟	zso
荛	rtea
氘	dfuii
忪	vhuo
纰	pxea
姹	cboo
桉	rdoo
氪	kfei
阍	hkua
旮	gsui
汊	ceaoo
纡	yxee
娉	pbi
傈	lkeiuu
缟	gxo
镢	jceu
垅	lyeuo
枥	ldeu
庥	xliu
堋	pyua
笮	zfue
缁	zxa
跞	lnuao
腭	rroi
蔺	ltoi
鹕	hiua
槊	smuu
魍	wdi
髂	qwoo
枳	vdoi
舻	lgi
蜍	cwie
醚	miou
鹧	vlua
鏊	roie
禳	rjoe
吒	vnuea
搿	guiu
珩	houu
钹	bceua
蒺	jtoeu
蜢	mwaii
鬻	yveo
卮	vgaa
苄	btoe
苕	stau
垭	yyei
菀	wtoo
袷	jjio
跹	xnue
瘘	lloua
骠	bxei
缶	ffii
鸷	vuuae
笸	pfe
磬	qyeu
纨	wxu
牦	mfuea
郓	yjai
阆	lkoa
琮	cooo
锒	lcoa
锕	rca
蕲	qtou
蠲	jmiau
芰	jtei
砩	fpa
妯	vbi
驷	sxiae
舢	sgia
趸	duoi
鹩	lpua
芫	yteeu
笊	vfuu
嗉	snee
蠊	lwoeo
枇	pdea
饴	ysaoo
莸	ytuae
阃	kkoi
浯	weei
焱	ymouo
柢	dduao
铆	mcua
擤	xuui
醢	hieui
帙	vwueo;	2
呲	znie
雱	pyoe
鹆	yauae
溆	xeia
碓	dpio
潴	veua
牖	ydoa
鬣	liaa
踞	jna
崾	ywei
堀	kya
疝	sliai
郴	cdai
桁	hduu
蛱	jweo
幂	mjuie
僳	skeio
獐	vsoe
鳏	gsiai
诎	qjaii
箝	qfei
呦	ynaaa
囹	lnioa
茴	htoi
揶	yuei
脲	nra
嗌	rnou
螈	yweuu
胨	dre
贽	vuiai
赅	gwoe
锑	tcou
痼	glo
膈	greo
镊	nce
鳊	bsoai
苤	pteu
峄	ywaoe
桡	rde
雎	jwioe
鲋	fsie
鞫	jiuao
鼬	ydiae;	2
疖	jlaii
昀	yguao
痍	ylea
熘	lmua
蟊	mzia
鞴	biei
獯	xsueo
侪	ckoe
炝	qmi
栀	vduua
炷	vmo
硐	dpia
鹂	liuae
嵴	jwoe
裾	jjaee
锸	ccuee
槲	hdua
羸	llouo
佰	bkeu
珐	foiu
哔	bneae
牯	gfeio
旆	plue
屙	rva
掾	yuaae
钪	kco
僦	jkoee
仟	qkue
圮	pyaea
芟	stua
崃	lweoo
跗	fnie
鲅	bseu
廪	lloeoi
擘	bvue
笱	gfua
苎	vtoo
圄	yneio
匏	ppua
彀	gyuaa
嗾	snoe
硷	jpio
卣	yroia
玳	doie
畛	vwiuu
涑	seeio
浞	veoi
勐	mcau
掴	guoie
赧	nya
粳	jmei
愍	mvo
刖	yri
逦	lioa
铄	scua
湫	jeue
椴	ddui
貉	hau
箧	qfea
擀	gueii
鲮	lsiu
茱	vtu
畈	fwuua
朐	qrua
訇	hsoe
悭	qhii
啖	dnou
蛘	ywoui
愀	qhu
鹨	lzu
凼	dea
苴	jtiae
佶	jkiuo
晟	cgeuo
缃	xxuu
颛	vweui
鲱	fsiei
厍	spea
佤	wkea
氡	dfua
徉	ygou
胗	vriu
洙	veue
锆	gcue
鞒	qiueu
癯	qlia
钺	ycea
勰	xbia
螭	cwoe
繇	yauai
肟	wre
肫	vrea
轸	vuiu
嵬	wwui
瘿	yliaa
邨	cuai
仞	rkauo
奁	lpea
轳	luiea
钼	mcia
睇	dwou
跆	tnaoo
樗	cdeo
蝼	lwoua
宄	ghu
鲰	zse
熳	mmu
铧	hci
馃	gsiao
裥	jjo
薜	btae
榇	cdoe
诶	rja
怄	rhea
帑	tbi
虺	hpi
鸱	csuae
硗	qpeae
矬	cfii
缗	mxae
碡	dpee
寤	wha
糅	rma
镧	lcoie
蹚	tnioi
雠	ckoai
虿	cuiao
埙	xyoi
悒	yhoi
硌	gpu
啁	vnua
犍	jfae
锩	jcou
蛑	mwaou
艉	wga
咴	hneuo
筮	sfeii
肄	ysae
糁	smao
鼍	tnoi
艏	sgo
劢	muau
籴	dao
砻	lpeuo
龀	crua
骜	roaa
蜮	yweao
黢	qwao
畚	bzeu
鹁	biu
稞	kfiao
耪	poo
鲲	ksu
觳	hyu
鬯	caua
捌	buoi
柘	vdeuo
娆	rbe
菔	ftua
鲀	tsea
篪	cfuu
獬	xsuaa
伥	ckue
狎	xsiai
孬	npau
谇	sjoe
聃	diiae
鄄	jiai
遒	qmo
滟	yeeeu
綦	qiaa
谰	ljoi
磔	vpua
鲡	lsei
齑	jlie
闫	ykee
钕	nca
泠	leio
砗	cpea
蔻	kto
镫	dcao
佥	qkoo
罘	fweu
胂	sria
菹	zteo
煅	dmui
煸	bmoai
嶝	dwao
鲠	gse
螯	roiao
躅	vnia
钋	pci
坨	tyoo
哞	mnao
洳	reau
盍	hyia
鸫	duuae
萘	nteu
菽	stiea
徜	cgio
渑	meoi
慊	qhou
踯	vnou
羰	tmia
褫	cjuu
縻	mlaa
灞	beeo
怛	dhu
俅	qkei
洮	teuoa
胼	prou
罴	pwiu
镛	ycoea
隳	hcii
芤	ktai
芊	qtuei
啉	lnuu
焐	wmei
绲	gxui
嫱	qbe
噌	cnouu
膻	sroe
亓	qoui
莼	cta
缒	vxui
嘞	lneia
蘅	htuu
倮	lkiao
镆	mcauu
伧	ckiaa
荏	rtiu
蚬	xwiaua
鸶	sxua
唳	lnoae
颎	jseuo
韫	youi
澍	seiu
檩	ldoeoi
蘖	ntui
骱	xwiu
怙	hhei
垡	fkiu
腚	dro
焯	vmieu
羧	smaou
鼙	pyui
嘏	giae
艽	jtuaa
荠	jtoeui
枵	xdoie
昴	mgua
倥	kkoo
亳	blue
粜	tcouo
魈	xdio
舨	bguu
醣	tioe
杓	bdua
茔	ytiue
珲	hooa
蛏	cwao
楸	qdueo
楦	xdoo
疃	twoei
髌	bwoo
甙	duei
蠛	mwauia
钣	bcuu
笄	jfeei
诼	vjeuo
跣	xnueu
蜣	qwoue
嬖	bva
铍	pca
喾	khueo
蜉	fwuoa
戆	gloa
陉	xca
瓴	lkea
薹	ttiu
岵	hweioi
肷	qruai
怫	fha
荽	stuo
缯	zxou
钭	tcoo
窀	vheaa
帔	pwa
倬	vkieu
蚶	hweie
楝	ldei
痱	flie
摭	vuoeo
螬	cwei
髑	dwi
衽	rjue
狷	jsoiu
萋	qtea
粝	lmeue
裉	kja
葭	jtaea
殛	jpai
鳢	lsiae
鼗	tai
钌	lca
罟	gweio
喁	yniao
傧	bkoo
愦	khiai
嫘	lbia
蝽	cwee
裼	tjui
哌	pnuu
衿	jjioa
锗	vceiu
墉	yyoea
廛	cliau
鐾	bvie
粢	zlou
醵	jiie
跫	qioi
扦	quuei
陟	vcie
堇	jiiae
脘	gro
婧	jbee
暌	kga
罱	lwei
镞	zcoe
蹰	cneu
鳔	bsei
岿	kwiu
侔	mkao
砹	rpau
疴	klei
麸	foee
郾	yuai
唿	hnuao
薨	htia
呒	rneea
拊	fuie
狯	ksie
眦	zwie
铳	ccoeu
偾	fkeii
椁	gdoeo
猢	hse
滁	ceai
裎	cjoi
榱	cdoei
璎	yoiaa
撺	cuooi
罾	zwou
鳚	wsae
缇	txui
蝣	ywoe
崞	gwoeo
冼	xlueu
狲	ssai
萑	htio
晷	ggua
痧	sleo
缱	qxi
帏	wwee
狍	psu
疠	llea
绨	txou
锛	bceue
蕖	qteo
窨	yhoeu
儋	dkua
袼	gjua
憷	chuua
汜	seaea
邰	tza
炅	ggo
虮	jwuaa
瓠	hpuu
蚰	ywi
嵝	lwouau
煳	hmeiu
窳	yhuu
蘩	ftue
庀	pluaa
泶	xheo
砀	dpau
莪	rtue
捩	luoa
蹉	cnoue
螽	vsia
苊	rteu
犸	msaa
衄	nda
蛲	nwe
槔	gduie
曛	xgue
隹	vkoe
鹾	croue
蘼	mtoei
玢	fou
泫	xeoea
酐	gieei
辊	guui
墀	cyae
瞋	cweiu
銎	qiie
尥	lpuao
畀	bweu
逑	qioa
硖	xpeoo
猗	yseue
逯	lvoa
堞	dyei
嵛	ywiu
噻	snoo
嚯	hneoi
鲃	bsai
呖	lneua
沆	heoeu
偬	zku
鹈	tmu
塬	yyeuu
鄞	yiaii
溧	leeiu
嫒	rbuo
缣	jxou
谵	vjuao
黧	lfiao
肭	nri
窭	jhou
鹱	hsaui
嬲	nwau
仫	mku
迕	wfoa
泔	geei
铋	bcoa
秫	sfuu
蒌	ltou
喱	lneui
溘	kei
箪	dfoui
酃	lya
鳙	ysoea
曩	ngo
赀	zria
裣	cjio
朊	rre
芑	qtae
盱	xwee
钎	qcuei;	2
胙	zru
挹	yuoia
捭	buui
悱	fhi
鬟	hiia
糇	hmia
钇	ycaa
甾	zxia
崤	ywuoe
铯	scuaa
缡	lxoe
鲚	jsoeui
澶	ceoeo
鹪	jkuae
瞽	gyia
欹	ypua
鞔	miuai
玎	doe
籼	xmi
庹	tlae
阊	ckuiu
湔	jeou
锜	qceu
嘬	cnui
燹	xpou
猊	nsui
锊	lcuo
舾	xgei
渖	seoo
岣	gwuaoi
钫	fco
钯	bcai
蚍	pwea
铒	rcei
葑	ftiu
敫	jdue
蓼	ltao
幛	vwoeui;	2
褊	bjoai
樘	cdio
篦	bfui
麇	jlueo
癔	yloeo
钔	mcoi
穸	xhuao
浼	meua
甯	nhoa
瑷	rouo
锼	scui
锿	rcoe
轫	ruau
戗	qkea
泮	peou
莩	ftuo
睃	swa
遄	cwoa
嵯	cwoue
皴	cza
瀣	xeie
逭	hhoa
炱	tzou
葚	rtei
锱	zca
篁	hfui
醍	tiui
褰	qhoe
驽	nbaa
筇	qfeia
睥	bwui
戥	dgea
辚	luouu
髀	bwuie
驺	zxu
鸺	xkuuu
迓	yuoa
砜	fpua
眇	mwiuu;	2
哙	kniee
逄	pso
炻	smeu
桤	qdia
疳	glei
楮	cdeiui
磙	gpo
鳇	hsuiee
濞	beuii
鹮	hwuae;	2
醭	biii
仡	gkue
栌	ldie
唢	snioi
菘	stuu
馇	csuu
醐	hieiu
殳	ssaoo
獍	jsoeua
尕	gbi
刿	gwii
殄	tpiu
祢	mjua
豉	cieia
锝	dcuie
暝	mgo
搴	qhue
薅	htau
磴	dpao
垴	nyo
葜	qtee
湓	peuoi
镅	mcaii
艚	cgei
氙	xfia
铑	lceiu
瓿	bleao
煺	tmae
蹀	dneiuu
蟥	hweii
黼	feei
杪	mdi
硭	mpau
蒡	btoeo
蒴	stouu
酽	yiei
膂	lluae;	2
踟	cnue
鲷	dsua
砬	lpoee
肜	rru
哏	gnae
硇	npu
殍	ppuo
猡	lsiau
旒	llueo
漯	teiaa
藁	gto
皤	pduo
鞲	gieeia
哿	gbei
锍	lcoeu
茭	jtoeuo
畋	twueo
姝	sbue
鸲	qsua
谂	sjioa
喹	kneui
跶	dneuo
溏	teoea
鲔	wseu
镬	hcau
橥	vsuu
窆	bhuo
髟	biuu
吣	qnoa
赉	lyia
骘	vca
缧	lxiaa
镓	jcoo
羼	cvou
窬	yhiua
邳	ppa
孥	nbaie
涠	weoi
鸸	rpuae
筌	qfie
溲	seui
璩	qoie
敉	mmue
苒	rtia
垓	gyo
荸	btei
脔	jliai
艟	cgoe
锪	hcua
镄	fca
甓	pvea
祆	xjee
婷	tbo
旄	mlue
彘	vxue
檠	qtuuo
胩	krie
柒	qeuuo;	2
啰	lnia
乂	yaoo
孑	jcee'	3
孓	jcoo;	2
丏	mia
仉	vkua
仂	lkau
夬	gvoo
爿	pcu
邗	hoai
匜	yuaia
叻	lnauu
犰	qsuaa
尻	kvu
耒	looo
圬	wyee
圹	kyoe
圯	yyae
夼	kpui
屺	qwae
伛	ykeauo
仵	wkuei
汆	caeo
汔	qeue
厾	dai
妁	sbuao
玕	goee
玙	yoeae
抔	pueu
抃	buoe
㧐	suaoa
苈	lteua
芼	mtuea;	2
杌	wdeu
邴	biaii
邶	bra
旰	ggee
旸	ygau
吽	hnue
吲	ynae
岈	xwea
兕	swuaa
牤	mfoe
豸	vau
坌	bai
狁	ysaou
疔	dleii
沔	meei
沚	veie
沨	feuau
沩	geou
泐	leai
怃	whee
忭	bho
妣	bbea
妤	ybao
刭	jzii
纴	rxu
玡	yoeau
玭	poea
玠	joiu
玥	youae
玦	joae
坩	gyeie
拤	quieo
坫	dyie
垆	lyie
劼	jyauu
拃	vuuee
坼	cyuu
坻	cyua
㧟	kueo
坭	nyae
苘	qtia
茌	ctiiu
茚	ytuaa
茆	mtuaa
茓	xtuo
茕	qtaei
茀	fta
枧	jdiau
枨	cdueo
杻	cdaie
刳	kpii
昃	zgeu
旻	mgoe
昉	fgoeu;	2
呣	rnaa
剀	kwii
邾	vfai
迮	zfoa
侑	ykeuu
侉	kkeu
佾	ykuo
徂	cgia
郄	qa
䏝	vree
郇	xsai
𬉼	om
炘	xmuu
沭	seuuo
泺	leuao
泖	meuaa
怍	zhu
㤘	vhua
怿	yhaoe
戽	hjoo
祎	yjee
陔	gcoeo
绁	xxeia
绂	fxeu
骀	dxa
顸	hoeui
珉	moae
垤	dyea
垱	dyio
垌	dyia
垧	syui
挦	xuae
荑	tte
贳	siia
荜	btea
茼	ttia
莛	ttue
荇	xtuu
荦	ltuei
剋	kiii
荬	mtao
荮	vtaa
柰	nde
栊	ldeuo
柙	xdia
柝	tduu
柈	pdou
柁	tdoo
柽	cdaoi
砘	dpea
殂	cpia
觇	criau
尜	gteu
眄	mwei
眍	kweau
𠳐	bnee
眊	mwue
哓	xnea
畎	qweuo
哕	hniau
哚	dnuauu;	2
峣	yweae
贶	kwoi
郜	gfai
秕	bfea
秭	zfua
牮	jkue
郗	caa
郤	xaai
狨	rsea
飑	bsuaa
昝	zsu
饸	hsio
饹	lsuao
娈	llaue
疬	lleua
疭	zlii
羑	ymuao
烀	hmuo
洧	weeu
洇	yeoi
洎	jeui
洫	xeuie;	2
浍	heie
浕	jeaeo
恓	xheie
扃	jjia
祓	fjeu
牁	gceio
姮	hbe
绗	hxuu
耖	coiu
珙	goei
珰	doio
珧	youoa
珣	xoua
琤	coua
埕	cyo
埘	syuie
埚	gyoi
埒	lyuo
垸	yyoo
捃	juaeoi
莳	stui
莨	ltoa
栲	kdeie
栳	ldeiu
梃	tdue
栝	gdueo
桕	jdui
栟	bdou
彧	yuoie
鬲	geoi
豇	jieie
砟	vpue
砼	tpie
剞	jpii
轾	vueai
辂	luua
唛	mne
眙	ywaooi
鸮	xnuae
趵	bnua
唣	znui
钲	vceie
钽	tcui
铈	scoe
铊	tcoou
铌	ncae
䥽	pcau
毪	mfao
盉	hfia
俵	bkee
俶	ckie
郫	pdai
脒	mro
猁	lsue
狳	ysie
猃	xsio
狺	ysoee
颃	hleui
訚	ykoe
烜	xme
剡	smii
浥	yeoia
悝	khiae
悛	qhao
陬	zcei
牂	zcou
绠	gxei
绡	xxiou
骎	qxa
耜	soia
琇	xoue
埴	vyeii
埯	rye
捯	duea
埸	yyu
埵	dyue
埤	pyuie
埝	nyi
堍	tyuao
捽	zuo
掊	puoe
堉	yyoeu
悫	qyo
埭	dya
萁	qteiu
萜	ttiai
棻	ftuu
萏	dtuau
菪	dtoo
菰	gtai
菡	htai
梿	ldoeoa
觋	xiia
桴	fduo
桷	jdua
棁	vdoii
桫	sdeo
酞	tieu
雩	yyee
眭	swiui
晡	bgei
眵	cwuau
圊	qneeu
晞	xguo
唵	rneuia
圉	yniuo
唼	snoea
帻	zwee
崚	lwiu
崦	yweui
赇	qweio
铗	jceo
铙	ncea
铟	ycoie
铪	hcio
铫	dcuo
铷	rcau
牾	wfei
秾	nfo
鸻	hguae
舴	zgue
脬	pruo
猞	ssie
阇	skeiu
焗	jmaea
淠	peia
惝	thi
惇	dhoeo
皲	jjau
郿	mcaii;	2
隈	wci
胬	nbia
欸	rzu
骐	qxei
骒	kxi
骖	cxao
耠	hoio
琫	boee
琯	goo
琚	joaee
揳	xuee
揸	vuuuu
揠	yuea
堙	yyeii
塄	lyiao
耋	diea
塆	wyoe
靰	wie
靸	siua
葳	wteu
葸	xtia
葶	tto
棼	fduoa
椟	ddeioo
棹	vdieu
棰	cduee
椪	puoo
椐	jdae
酤	giei
酡	tioo
辋	wui
椠	quuu
睄	swiou
戢	jnei
喈	jnea
跖	vneuo
嗞	znou
嵖	cwuu
嵎	ywia
嵫	zwoua
赕	dwouo
铻	wce
铼	lceoo
锇	rcu
锔	jcaea
毳	cfueu
毽	jfaea
犋	jfiauo
稃	ffuo
稂	lfoa
筚	bfeae
舄	xduao
媭	xgau
腈	jreeu
猹	csuuu
觚	gsuu
猱	nsa
裒	plui
痦	wlei
鹇	xkuae
粞	xmei
焜	kmui
渫	xeei
湜	seuie
湲	yeuoe
湉	teoou
愔	yhoeui
祾	ljiu
巯	qzo
翚	hze
缌	sxiao
缑	gxiae
耢	loa
瑗	youoe
瑄	xooo
趑	zyoe
摅	suieo
搋	cuuui
搛	juou
搠	suouu
搦	nuaea
蓁	vtee
蓍	stei
蓐	rteue
鹋	mtuae
蒽	rtoio
蓊	wtuo
蓠	ltoe
蒟	jioe
蒹	jtou
蒗	lteoo
蓥	ytie
楯	siuu
訾	zro
睚	yweuiu
跬	kniui
跐	cnieu
蛸	swioua
嗐	hnoo
罨	yweuia
锞	kciao
犏	pfo
歃	sfuai
筢	pfei
筲	sfiou
毹	skue
貊	mae
貅	xai
腠	cre
腩	nrei
腧	sriu
塍	croui
媵	yrou
鲐	tsao
鹐	qsuae
亶	dlo
瘃	vleuo
瘐	yluio
瘆	slaou
溱	veee
漭	meaue
溽	reeu
溻	teuia
溷	heoie
滗	beue
滫	xeiu
滏	feuoe
滃	whuo
滪	yhaoeu
禊	xjeee
嫫	mbau
骝	lxuai
骟	sxoa
耥	toio
璈	roee
獒	roeu
觏	goia
慝	tuoao
叆	rouoe
摽	bueiee
墁	myui
撄	yuiaa
翥	viao
榖	gyuaao
靺	mie
靿	yiaa
甍	mtiaea
蔸	dtui
蔟	ctoeu
槠	vdoae
僰	biuo
酹	liuo
碲	dpoe
豨	xpuo
䁖	lwouau;	2
蜞	qweiu
蜱	pwui
蜩	twuai
嘡	tnioiu
嘚	dnuu
赙	fwei
箐	qfee
箦	zfee
箬	rfa
箅	bfi
箜	kfoo
箢	wfoo
劁	qkii
魆	xdeao
艋	mga
觫	sseio
瘌	lleii
瘊	hli
阚	kka
鲞	xmua
粿	gmia
熥	tmoa
滹	heieu
漶	heiao
潋	leiue
澉	geaeu
綮	qjaa
谮	zjea
褙	bjie
屣	xvu
鹛	mcuae
嫚	mbui
瞀	mziae
骢	cxui
耧	loou
璁	coui
奭	speue
髫	tiuio
撙	zuou
蕈	xtei
蕤	rteuu
蕞	ztu
蕺	jtoie
瞢	mtiai
醌	kiui
醅	pio
霈	pyeo
颙	yweuia;	2
踒	wnue
踬	vnuue
踺	jnaea
蝾	rwau
蝻	nwei
蝰	kweu
螋	swui
蝓	ywiua
噍	jnio
幞	fwi
骺	hwuu
镔	bcoo
篌	hfiae
鲣	jsii
鲥	ssuie
鲩	hsoo
瘼	mlau
𥻗	cmuu
糌	zmu
糍	cmou
熜	zmui
澌	seeiu
潲	seuei
潟	xeuiu
谳	yjei
褟	tjuia
屦	jvuuo
蝥	mziao
骣	cxae
耩	joeei
璟	joui
璠	fouo
璘	loouu
聱	roei
髹	xiiuu
甏	bye
縠	hyua
蕻	hteie
颟	mteui
薤	xteu
檎	qdioe
樨	xdae
橼	ydaa
墼	jiiue
翮	hiao
磲	qpeo
殪	ypiu
嚄	hnaui
嚆	hnauo
暾	tgoe
蹁	pno
螠	ywouia
䦃	vcau
镗	tcio
镘	mcui
镚	bcia
镝	dcoe
镠	lcao
氇	lfua
氆	pfou
篥	lfeiu
劓	ydii
徼	jgui
膦	lrou
膙	jsaeo
鲳	csui
鲴	gsoi
鲵	nsuiu
鲻	zsaa
獴	msaue
廨	xluaa
赟	yliai
瘰	lliaa
瘵	vluae
癃	llaiu
瘳	cla
麈	vloee
糗	qmui
燠	ymuie
澥	xeuaa
隰	xcuia
颡	szeu
缲	qxoi
缳	hxia
璪	zoo
鞡	lie
鞬	jiae
薷	rteo
礅	dpoeu
豳	bweue
黻	feeu
螵	pweie
罽	jwou
嶷	ywuaa
镡	cceiu
镦	dcoeu
镩	ccoo
镪	qca
篼	dfuiu
簖	dfouu
簋	gfae
鼢	fduoau
龠	ykoii
貘	maa
貔	pau
臌	griu
鲼	fsei
鲽	dsei
鳀	tsuie
癍	bleeo
檗	bvuu
鞨	hiui
鞧	qioue
藠	jiuiu
礓	jpei
黟	ywuau
鳐	ysuo
糨	jmaeo
鬏	jiue
攉	hueo
蘧	qtie
霪	yyeou
霨	wya
蹽	lneuui
蹾	dnoeu
镲	ccoou
籀	vfeiua
齁	hduao
艨	mgau
鳓	lseia
㸆	omu
襦	rjeo
襞	bvo
缵	zxue
巉	cwuou
黥	qwoeo
黪	cwaoe
镴	lcaa
璺	wdee
鼯	wdei
臜	zrue
鳜	gseu
瓘	goa
爝	jmuo
耱	moo
氍	qwue
躐	lnaa
镵	ccua
趱	zyu
躜	znuei
躞	xnoe
襻	pjuu
纛	doia
攮	nuei
爨	cduu
齉	ndeu
亍	coii
尢	wpaa
彳	cgii
卬	rsii
𠙶	rcai
毌	gxee
邘	yoai
戋	joo
圢	tyeii
氕	pfuu
伋	jkuao
仝	tkeie
冮	gleie
氿	geua
汈	deea
氾	feaa
忉	dhau
𬣙	oj
讱	rjau
扞	huee
圲	qyuei
圫	tyuea
芃	ptua
朳	bduo
朸	ldauu
𨙸	qiaii
吖	rnoui
屼	wweua
屾	swia
辿	cwoao
钆	gca
仳	pke
伣	xkia
伈	xkoa
癿	qdaa
甪	lgii
邠	baai
犴	rsee
冱	hlea
邡	flai
𬇕	oh
汋	veuao
䜣	xjuu
讻	xjuoa
𬣞	ojo
孖	zcai
𬘓	ox
纩	kxo
玒	hoeie
玓	dou
玘	qoa
玚	yoauu
刬	coiii
𫭟	oi
坜	lyeua
坉	tyea
扽	dueaa
𫭢	oiu
坋	fyu
扺	vuuaa;	2
㧑	hiau
毐	ryaa
芣	fteu
苉	ptea
芘	pteau
芴	wtuau
芠	wtoe
𫇭	oia
杩	mdaa
轪	dueuo
𫐄	yueua;	2
芈	mree
呙	gnia
㕮	fwuou
岍	qweei
𫵷	ow
岜	bwa
冏	jwuo
岙	rfia
伾	pkeu
㑇	vkuaa
伭	xkoe
佖	bkoa
佁	ykaoo
狃	nsai
𣲘	wheea
𣲗	wheei
𬇙	ohi
㳇	fhu
忮	vhei
𬣡	oje
诇	xjia
邲	bja
诐	bjau
𫸩	ov
阽	dcie
䢺	ccai
阼	zcue
𨚕	bza
纮	hxe
𫘜	oxo
𬘘	oxoa
𫘝	jxae
玟	mooe
邽	gya
邿	syai
坥	jyi
坰	jyia
坬	gyuu
坽	lyiao;	2
耵	dieii
䢼	giai
𦭜	viia
苠	mtae
㭎	giiau
枘	rdia
匼	kuio
𬨂	ou
𬀩	owe
𬀪	owi
岽	dweao
㟃	swae
𬬩	of
钐	scuu
钖	ycau
佴	rkei
侁	skueu
侹	tkue
佸	hkue
佺	qkie
㑊	ykoeo
侂	tkoeu
佽	ckoeu
侘	ckoo
郐	kkai
饳	dsai
炌	kmi
炆	wmoe
怊	chau
鸤	svua
弨	cvau
卺	jcaa
驵	zxiae
绋	fxa
绐	dxao
耔	zoa
珅	soiai
垯	dyeu
垙	gyio
垲	kyia
埏	syuia
垍	jyui
鿍	oy
垎	hyuao
垟	yyou
垞	cyoo
垵	ryoo
垏	lyae
拶	zuaa
茈	zti
茺	ctoeua
茳	jteoe
茛	gtae
柃	ldio
砑	ypea
轵	vuoiu
轷	huuo
轹	luuao
轺	yuau
耑	vweui;	2
钘	xce
钬	hco
矧	sfaei
俫	lkeo
舁	ydeu
俜	pkia
俙	xkuo
俍	lkoao
舣	ygouo
鸧	ckuae
饻	xsoe
疢	clou
炣	kme
炟	dmuie
㶲	ymuai
泚	ceie
浈	veiei
洚	jeuae
陧	ncui
绖	dxe
彖	txeu
恝	jooa
珪	goiu
埗	byie
垾	ryu
垺	fyuo
埆	qyua
垿	xyoe
埌	lyoa
埇	yyao
莰	ktiu
莶	ltioo
桄	gdio
酎	viei
酏	yiaia
恧	npo
𨐈	guio
辀	vuuuo
辁	quiee
哳	vnei
帱	cweee
赆	jwaeo
钷	pce
眚	sfiae
倻	ykeia
倴	bkeue
脩	xkuau
倕	ckuee
倞	jkoeo
倓	tkou
倧	zko
舭	bgea
舯	vgia
瓞	dgu
鸰	lkua
脎	sruo
胲	hro
鱽	dsau
狴	bsea
眢	ysia
痄	vluee
疰	vloee;	2
痃	xloe
羖	gmu
羓	bmai
桊	jmuu
悃	khoi
袪	qjiua
祧	tjuo
陴	pcui
剟	dzii
掭	tueei
堎	lyiu
堐	yyeui
埼	qyeue
掎	jueue
埫	cyio
堌	gyoie
埪	kyoo
壸	kyee
聍	nioo
菝	bteie
菥	stuuu
䓫	qteue
䓬	oii
萆	btuie
鿎	op
唪	fneee
畤	vwiue
趼	jneei
跂	qnei
蚺	rwiae
崟	ywie
铏	xcee
铕	yceu
铖	cceu
铘	yceaa
铚	vcea
铞	dcoi
铥	dcue
铴	tceo
牿	gfue
稆	lfoi
偰	xkee
偡	vkei
偭	mke
偲	ckiao
偁	ckuo
㿠	hdio
偓	wka
徛	jge
舳	vgiae
鸼	dgua
脶	lroii
脞	crii
鱾	jsaea
觖	jsaeo;	2
庳	bluie
堃	kliu
羝	dmua
悰	choo
谞	xjai
艴	fvu
婍	qbeu
婠	wboo
绹	txua
堾	cyee
揕	vueiu
堧	ryeu
喆	vyiu
堨	ryui
塅	dyui
堠	hyiae
絷	vuaai
𪣻	oyo
𡎚	pyoa
葙	xtuui
蒇	cteui
蒈	ktea
蒉	ktia
蒎	pteou
楗	jdaea
觌	diiau
皕	bpeu
𫐐	nuui
辌	luoeo
黹	veouo
嵁	kweiu
赑	bwia
赒	vwuai
鿏	oc
铹	lcau
铽	tcea
锎	kcoi
锓	qcae
筘	kfeio
筅	xfue
傃	skeea
傉	nkeu
翛	skuaa
傒	xkuoa
傕	jkoa
腙	zroo
馉	gsiau
毵	szue
矞	yziau
遘	gooa
塥	gyeo
堽	gyiae
塝	byo
搌	vuaee
蓣	ytaoe
椹	sdei
楙	mdao
辒	wuui
𫐓	ruaouu
觜	zrua
鹍	kgu
跱	vniu
赗	fwia
锖	qceeu
锘	ncau
锳	ycaui
锧	vcuu
锫	pcoe
锬	tcouou
筻	gfeio;	2
傺	ckuaee
鹎	bduae
僇	lkaoi
腽	wru
鲉	csia
鲊	vsue
鲌	bsui
鲏	psa
𦝼	lroua
馌	ysiui
廒	rlee
瘅	dlou
煁	cmei
滠	seeia
滉	heuii
谫	jjou
戤	gbea
瑱	toei
墕	yyeie
墈	kyeia
墐	jyei
墘	qyeiu
𡐓	kyoea
墚	lyeo
撖	huae
𪤗	oya
蔌	steiu
蓰	xtuuie
蔹	ltiue
榍	xdaei
酾	sie
酲	cioi
酴	tiie
碹	xpoo
碥	bpoa
劂	jpiii
䴗	jwuae
瞍	swuia
㬎	xgaa
跽	jnaeo
蜾	gwiao
锽	hcui
锾	hcuo
镃	zcoua
馝	bfoa
箨	tfei
僬	jkioo
僔	zkou
僎	vka
槃	pguu
鲒	jsiu
鲕	rseu
鲖	tsi
鲗	zsi
鲘	hsuuo
鲙	ksiee
廑	jleii
瘗	yleo
瘥	cloue
瘕	jlae
鲝	vmuai
鄫	cma
漹	yeeie
漤	leuua
禛	vjeiuo
禚	vjou
嫜	vbo
墣	pyi
墦	fyuoi
墡	syou
劐	htii
槱	ydeio
磉	spao
踦	jneue
踣	bno
蝤	qwouei
镈	bceiei
镋	tcioo
镎	nciu
儇	xkiae
皞	hduie
鲦	tsua
鲪	jsaeoi
鲬	ysaoi
觭	jseue
糈	xmai
鹣	jmua
憙	xyoo
擐	huia
鄹	zia
蕗	ltoiu
蕹	wtoea
醑	xiaiu
𫟦	ouo
蹅	cnuu
踶	dnui
螗	twoea
馞	bfeia
篚	ffe
鼽	qdua
衠	vgei
鲭	qsee
鲯	qsei
鲺	ssau
鲹	ssaoe
癀	hlei
瘭	blei
羱	ymeu
燋	jmui
黉	hheii
嬛	hbia
檑	ldeo
磻	ppuoi
瞵	lwouua
蹐	jnoeu
镤	pcii
镥	lcuau
镨	pcou
簏	lfoee
儦	bkoeoo
鲾	bseo
鲿	csioe
鳁	wsui
鳂	wsiae
鳈	qsui
鳉	jsoeua;	2
䗪	vliao
馘	gme
爇	rteio
藨	btoeoo
檫	cdoo
礞	mpaue
蹢	dnoeia
蹜	snooi
镮	hcia
镱	ycoeo
鼩	qduao
皦	jduiu
臑	nreo
鳑	psoe
鳒	jsouo
冁	cmae
䎖	zmao
瀌	beoeo
嚭	pyee
蹯	fnuo
鳘	mfua
儳	ckuau
儴	rkoe
鳛	xsao
蠃	lliao
嬿	ybeio
鬒	vieiu
颥	ryeui
瀹	yeii
瀵	feou
鼱	jdeeu
鳠	hsaui;	2
鳡	gseuo
鳣	vsoei
躔	cnoei
皭	jduo
鳤	gsue
鼷	xduoa
齇	vdiei
拋	pueua
珮	pou
袊	ljio
吶	nnia
闇	rwoe
幷	bfue
柟	ndi
伷	vkiae
勣	joau
吋	cneio
呎	cnae
噹	dnio
埶	syua
妳	nbua
崓	gwoiei
搧	suoaa
暐	wgai
澐	yeeo
澔	heuiu
濛	meauee
獏	msaui
綄	hxoo
菑	zta
蓱	pteoo
蹓	lnuai
揎	xuoo
囝	jnai
欷	xau
顗	yweuia'	3
疋	pcoo
螓	qweeu
舡	cgeie
麤	cloeo
〇	laa
瞇	mwou
肏	caiai
袩	vjiei
讬	tjue
诪	vjee
谉	sjoo
豻	raee
佧	kkieo
氽	tkeo
趶	knee
趷	knue
趹	jnaeo;	2
趻	cnio
趽	fno
跅	tnuu
跓	vnoe
阢	wceu
坶	mya
茇	bteu
挢	juueu
揲	dueie
揞	ruoei
邒	tia
邔	qvai
邖	swai
邚	rbai
邜	xsaii
邞	foai
邟	klaii
邤	xgai
邥	sjai
邧	yoaii
邩	hma
邫	booi
邭	jsai
邷	wuai
邼	kuai
郀	kpa
擗	puae
哜	jnoeui
猸	msaii
沲	teue
弪	jvaoe
缍	dxue
缋	hxiai
缏	bxui
钑	scuao
铇	bcuaa
铓	mcauo
铔	ycei
铦	xcuei
锠	cciai
楱	cdeee
榀	pdia
軎	wioi
攴	pra
膣	vroo
膪	croe
鞜	tieo
憝	dloa
礤	cpau
钶	kcei
钸	bceui
镙	lciaa
镟	xcoeu
饤	dseii
饦	tsue
饾	dseia
馂	jsao
痖	ylei
馚	ffuoa
馛	bfeu
馜	nfae
馟	tfuo
馠	hfii
馡	ffiei
蚵	kweioi
蟓	xwuai
糸	mxiu
麴	qiuao
謦	qyoe
鳆	fsue
鳋	ssaoi
鱻	xsuau
鲄	hsei
鲓	kse
齄	vduui
	oyu
峏	oweu
	ope
乢	gwa
乣	jxaa
乤	xiaa
囧	jnuo
