并	b_
重	c_
大	d_
是	f_
一	g_
不	h_
种	i_
有	j_
的	k_
来	l_
们	m_
你	n_
平	p_
起	q_
人	r_
事	s_
他	t_
我	w_
下	x_
以	y_
必	b.
办	b/
变	b;
布	ba
避	bb
标	bc
百	bd
展	be
本	bf
表	bg
部	bh
别	bi
便	bj
把	bk
被	bl
八	bm
宝	bn
备	bo
步	bp
般	bq
白	br
比	bs
笔	bt
引	bu
吧	bv
包	bw
编	bx
北	by
边	bz
存	c,
常	c.
程	c/
产	c;
成	ca
层	cb
查	cc
沉	cd
草	ce
才	cf
传	cg
次	ch
吃	ci
从	cj
持	ck
词	cl
差	cm
穿	cn
曾	co
尘	cp
船	cq
春	cr
车	cs
长	ct
城	cu
出	cv
处	cw
纯	cx
此	cy
场	cz
带	d,
单	d.
代	d/
底	d;
达	da
导	db
电	dc
淡	dd
满	de
都	df
动	dg
度	dh
第	di
当	dj
打	dk
对	dl
道	dm
定	dn
但	do
东	dp
断	dq
段	dr
到	ds
答	dt
地	du
队	dv
多	dw
海	dx
点	dy
刀	dz
真	f/
否	fa
费	fb
飞	fc
法	fd
范	fe
整	ff
夫	fg
放	fh
古	fi
份	fj
方	fk
房	fl
父	fm
富	fn
直	fo
反	fq
者	fr
妇	fs
教	ft
复	fu
服	fv
风	fw
纷	fx
非	fy
发	fz
更	g,
光	g.
告	g/
过	g;
感	ga
改	gb
根	gc
工	gd
格	ge
故	gf
干	gg
广	gh
跟	gi
个	gj
高	gk
该	gl
关	gm
官	gn
国	go
归	gp
瓜	gq
果	gr
姑	gs
管	gt
刚	gu
云	gv
各	gw
给	gx
钢	gy
功	gz
或	h,
合	h/
黑	h;
还	ha
候	hb
横	hc
活	hd
花	he
何	hf
环	hg
装	hh
号	hi
会	hj
很	hk
话	hl
火	hm
害	hn
回	ho
后	hq
音	hr
好	hs
和	ht
乎	hu
孩	hv
将	hw
红	hx
站	hy
化	hz
再	i,
怎	i.
住	i/
主	i;
在	ia
张	ib
之	ic
注	id
着	ie
正	if
转	ig
这	ih
只	ii
作	ij
指	ik
证	il
总	im
字	in
中	io
则	ip
质	iq
自	ir
至	is
知	it
走	iu
子	iv
周	iw
组	ix
战	iy
另	iz
极	j,
计	j.
几	j/
交	j;
就	ja
即	jb
机	jc
江	jd
节	je
做	jf
进	jg
决	jh
叫	ji
今	jj
接	jk
记	jl
具	jm
觉	jn
见	jo
尖	jp
近	jq
间	jr
较	js
件	jt
结	ju
己	jv
及	jw
绝	jx
金	jy
加	jz
哭	ka
据	kb
困	kc
可	kd
苦	ke
克	kf
开	kg
刻	kh
口	ki
推	kj
控	kk
课	kl
烤	km
快	kn
看	ko
得	kr
找	ks
科	kt
块	ku
报	kv
客	kw
空	kx
肯	ky
势	kz
六	l/
离	l;
历	la
灵	lb
李	lc
流	ld
落	le
两	lf
理	lg
立	lh
路	li
令	lj
拉	lk
论	ll
类	lm
连	ln
里	lo
劣	lp
诉	lq
量	lr
军	ls
利	lt
老	lu
了	lv
调	lw
练	lx
虑	ly
力	lz
命	m/
母	m;
面	ma
民	mb
模	mc
没	md
么	me
某	mf
精	mg
麻	mh
吗	mi
门	mj
描	mk
公	ml
美	mm
慢	mn
目	mo
明	mr
妈	ms
每	mt
半	mu
前	mv
名	mw
马	mx
铭	my
分	mz
家	na
那	nb
想	nc
深	nd
呢	ne
南	nf
于	ng
应	nh
哪	ni
念	nj
拿	nk
难	nl
受	nm
宁	nn
内	no
早	nr
女	ns
年	nt
举	nu
能	nv
它	nw
经	nx
虐	ny
男	nz
破	pa
屏	pb
棚	pc
派	pd
少	pe
师	pf
璞	pg
旁	ph
品	pi
偏	pj
排	pk
评	pl
普	pm
怕	pn
盼	po
盘	pq
片	pr
匹	ps
篇	pt
培	pu
朋	pv
跑	pw
骗	px
频	py
皮	pz
七	q,
期	q/
求	q;
确	qa
强	qb
权	qc
清	qd
千	qe
取	qf
青	qg
亲	qh
器	qi
全	qj
抢	qk
请	ql
其	qm
情	qn
且	qo
雀	qp
秋	qq
晴	qr
轻	qs
气	qt
去	qu
却	qv
欠	qw
骑	qx
钱	qy
切	qz
入	r/
然	r;
而	ra
弱	rb
榕	rc
融	rd
若	re
最	rf
二	rg
景	rh
啊	ri
仍	rj
热	rk
认	rl
爱	rm
安	rn
容	ro
尔	rp
影	rq
日	rr
软	rs
任	rt
如	ru
阿	rv
儿	rw
绕	rx
让	ry
忍	rz
十	s,
神	s.
算	s/
死	sa
司	sb
术	sc
水	sd
身	se
世	sf
三	sg
商	sh
四	si
使	sj
手	sk
说	sl
数	sm
实	sn
山	so
省	sp
所	sq
时	sr
式	ss
生	st
声	su
随	sv
色	sw
书	sx
上	sy
奶	sz
太	t,
谈	t.
通	t;
态	ta
退	tb
桃	tc
添	td
特	te
团	tf
天	tg
痛	th
听	ti
体	tj
提	tk
台	tl
逃	tm
头	tn
同	to
艇	tq
题	tr
她	ts
笑	tt
等	tu
脱	tv
条	tw
统	tx
铁	ty
图	tz
王	w,
望	w;
威	wa
屋	wb
杂	wc
温	wd
九	we
五	wf
武	wg
文	wh
问	wi
位	wj
往	wk
谓	wl
为	wm
完	wn
网	wo
乐	wp
饭	wq
晚	wr
万	ws
物	wt
无	wu
卫	wv
务	ww
维	wx
外	wy
解	wz
需	x,
心	x.
信	x/
兴	x;
雄	xa
寻	xb
相	xc
消	xd
系	xe
西	xf
形	xg
新	xh
息	xi
像	xj
行	xk
许	xl
希	xm
性	xn
现	xo
小	xp
须	xq
向	xr
写	xs
先	xt
喜	xu
学	xv
象	xw
线	xx
些	xy
终	xz
由	y,
语	y.
月	y/
原	ya
已	yb
样	yc
游	yd
英	ye
要	yf
运	yg
言	yh
意	yi
依	yj
义	yk
又	yl
烟	ym
远	yn
眼	yo
殷	yq
易	yr
与	ys
移	yt
业	yu
也	yv
用	yw
约	yx
银	yy
孕	yz
飙	ba/
磅	ba;
奔	baa
碑	bae
泵	bau
甭	baz
屄	bb;
弼	bba
擘	bbe
壁	bbu
臂	bbv
槟	bc/
榜	bc;
杯	bca
板	bce
柏	bco
棒	bcu
梆	bcv
滨	bd/
逼	bd;
泊	bde
渤	bdu
波	bdz
蔽	be/
薄	be;
苯	bea
葆	bee
币	beo
蔽	beu
芭	bev
苞	bez
丙	bf;
博	bfa
鞭	bfe
贲	bfo
靶	bfv
勃	bfz
班	bg/
斑	bg;
碧	bga
帮	bgo
班	bgu
邦	bgv
辨	bh/
辩	bh;
病	bha
霸	bhe
禀	bho
冰	bhu
辫	bhv
雹	bhz
叭	bi/
啵	bi;
跋	bia
蹦	bio
卟	biu
鄙	biv
跛	biz
伴	bj/
倍	bj;
闭	bja
伯	bje
保	bjo
堡	bju
傍	bjv
播	bk/
摈	bk;
捕	bka
搬	bke
摆	bko
拜	bku
彼	bkv
抱	bkz
遍	bl;
畚	bla
裨	ble
扁	blo
补	blu
迸	bm;
弊	bma
颁	bme
爆	bmo
爸	bmv
豹	bmz
忭	bn;
怖	bna
宾	bne
悖	bnu
愎	bnz
贝	bo/
髌	bo;
败	boe
赑	boo
罢	bou
崩	bov
舶	bqe
舨	bqv
兵	br/
暴	bra
版	bre
鼻	bro
暴	bru
匾	bs;
毙	bsa
婢	bse
毕	bsu
匾	bsv
簿	bt;
笨	bta
稗	bte
秉	bto
拜	btu
笆	btv
埠	bue
坝	buo
膀	bv;
膊	bva
阪	bve
脖	bvu
巴	bvv
胞	bvz
饼	bw/
鲅	bwa
惫	bwo
饽	bwu
匕	bwv
饱	bwz
驳	bx/
缤	bx;
骠	bxa
绑	bxu
绷	bxv
悲	by;
辈	bya
彪	bye
钡	byo
步	byu
背	byv
龅	byz
磁	ca/
厨	caa
厂	cae
盛	cao
残	cau
础	cav
迟	cb;
丑	cba
尺	cbo
弛	cbv
村	cc;
材	cca
槌	cce
椿	ccu
楚	ccv
沧	cd/
澈	cd;
漕	cda
测	cdo
潮	cdu
池	cdv
茶	ce/
萃	ce;
藏	cea
菜	cee
囱	ceo
蔡	ceu
苍	cev
葱	cez
聪	cf/
寸	cf;
臣	cfa
醋	cfe
曹	cfo
刺	cfu
朝	cfv
琮	cg;
蠢	cgo
璨	cgu
琛	cgv
疮	ch/
瘁	ch;
床	cha
充	che
冲	cho
凑	chu
畜	chv
鹑	chz
踩	ci/
逞	ci;
呈	cia
踩	cie
唱	cio
吵	ciu
嘲	civ
吹	ciz
阐	cj/
丛	cja
敞	cje
侧	cjo
创	cju
仓	cjv
仇	cjz
挫	ck/
擦	ck;
操	cka
插	cke
抽	cko
撑	cku
惩	ckv
彻	ckz
禅	cl/
叉	cl;
诚	cla
参	cle
昶	clo
翠	clu
祠	clv
初	clz
糍	cm/
粹	cm;
采	cma
彩	cme
粗	cmo
炒	cmu
慈	cmv
炊	cmz
察	cn/
悴	cn;
宠	cna
窗	cne
窜	cno
恻	cnu
惨	cnv
察	cnz
睬	co/
虫	co;
财	coa
崔	coe
赐	coo
串	cou
眦	cov
畅	coz
舱	cq/
斥	cq;
晁	cr/
臭	cr;
晨	cra
昌	cro
川	cru
婵	cs/
姹	cs;
娼	cso
辍	csv
矬	ct/
辞	ct;
策	cta
掣	cte
乘	ctu
愁	ctv
称	ctz
趁	cu/
赤	cue
超	cuz
除	cv/
承	cv;
陈	cva
陲	cve
蚩	cvo
丑	cvu
肠	cvv
脆	cvz
匆	cw;
册	cwa
雏	cwe
触	cwo
猜	cwu
刍	cwv
馋	cwz
缠	cx;
骢	cxe
巢	cxo
绰	cxu
驰	cxv
绸	cxz
餐	cy/
铲	cy;
柴	cya
错	cye
锄	cyo
钞	cyu
齿	cyv
殚	da/
歹	da;
夺	daa
碟	dae
碘	dao
殆	dav
砀	daz
弹	db/
逮	db;
刁	dba
屌	dbo
刁	dbv
殿	dbz
栋	dca
椴	dce
杜	dcu
棣	dcv
豆	dd/
滴	dd;
沌	dda
洞	ddo
渎	ddu
渡	ddv
涤	ddz
荡	de;
荳	dea
董	dee
丢	dev
荻	dez
颠	df/
鞑	df;
酊	dfa
顶	dfe
戴	dfo
丁	dfu
耽	dfv
靛	dg;
毒	dgv
冻	dha
敦	dhe
端	dho
店	dhu
癜	dhv
凋	dhz
蹲	di/
踱	di;
呆	dia
跌	die
吊	dio
嘟	diu
蹬	div
叨	diz
贷	dj/
袋	dj;
倒	dja
党	dje
贷	djo
傣	dju
低	djz
掸	dk/
抖	dk;
德	dka
搭	dke
担	dko
待	dku
挡	dkv
抵	dkz
登	dl/
谛	dl;
订	dla
诞	dle
叠	dlo
读	dlu
邓	dlv
凳	dlz
籴	dm/
递	dm;
灯	dma
煅	dme
兑	dmo
弟	dmv
爹	dmz
惮	dn/
惦	dn;
惰	dna
懂	dne
恫	dno
斗	dnu
典	do/
迪	do;
盯	doa
蝶	doe
睹	doo
赌	dou
鼎	dov
骶	doz
遁	dq;
盾	dqu
舵	dqz
旦	dra
兜	dre
牍	dru
躲	drz
娣	ds/
嫡	ds;
甙	dsa
顿	dse
岱	dso
妒	dsv
稻	dt/
迭	dt;
短	dta
敌	dte
笛	dto
笃	dtv
氡	dtz
墩	du;
堆	due
堤	duo
堵	duu
埭	duv
垛	duz
蛋	dv;
胆	dvo
肚	dvu
狄	dw/
冬	dw;
朵	dwa
雕	dwe
独	dwo
岛	dwu
邸	dwv
绨	dx/
缔	dx;
驮	dxa
缎	dxe
镀	dy;
钉	dya
锻	dye
督	dyo
铛	dyu
铎	dyv
钓	dyz
奋	fao
砝	fau
矾	faz
弗	fbu
焚	fc/
梵	fc;
樊	fca
枫	fcz
浮	fd/
涪	fd;
沣	fda
泛	fde
副	fdu
沸	fdv
芬	fe/
芳	fe;
菲	fea
芙	feu
乏	fev
酚	ff/
甫	ff;
覆	ffe
奉	fga
璠	fge
丰	fgu
疯	fh/
府	fhe
腐	fho
霏	fhu
冯	fhv
废	fhz
吠	fia
咐	fie
啡	fiu
俘	fj/
仿	fj;
付	fja
阀	fje
仆	fju
佛	fjv
彷	fk;
抚	fka
扶	fku
拂	fkv
访	fl;
福	fla
袱	fle
扉	flu
讽	flz
粉	fm/
釜	fma
烦	fme
番	fmo
釜	fmu
翻	fmv
烽	fmz
愤	fnu
怫	fnv
幡	fo/
帆	fo;
幅	foa
贩	foe
蝠	foo
赋	fou
罚	fov
峰	foz
返	fq;
舫	fqv
鼢	fr/
阜	fru
妨	fs;
辅	fsa
辐	fso
匪	fsu
妃	fsv
氛	ft/
符	fte
缶	ftu
繁	ftv
坟	fu;
封	fua
赴	fuu
坊	fuv
防	fv;
脯	fva
附	fve
肤	fvu
肥	fvv
孵	fw/
凡	fw;
匐	fwa
饭	fwe
负	fwo
犯	fwv
凫	fwz
纺	fx;
缚	fxa
驸	fxe
绯	fxu
缝	fxz
斐	fy;
蜚	fyo
翡	fyv
锋	fyz
尬	ga/
戛	gaa
顾	gae
硅	gau
硌	gaz
艮	gb;
敢	gbe
弓	gbv
桧	gc/
棺	gc;
柜	gca
柑	gce
棍	gco
桂	gcu
概	gcv
构	gcz
淦	gd/
滚	gd;
泔	gda
港	gde
亘	gdo
沽	gdu
溉	gdv
沟	gdz
莞	ge;
鹳	gee
葛	geo
菇	gev
苟	gez
共	gf/
辜	gf;
哥	gfa
攻	gfe
革	gfo
甘	gfu
丐	gfv
歌	gfz
耕	gga
瑰	gge
规	ggo
汞	ggu
疳	gha
裹	gho
郭	ghv
赣	ghz
嘎	gia
呱	gie
呙	gio
咕	giu
哏	giv
跪	giz
倌	gj;
供	gje
估	gju
阁	gjz
搞	gk;
拱	gke
搁	gko
挂	gku
撖	gkv
拐	gkz
雇	gle
观	glo
冠	glu
诡	glz
谷	gm/
糕	gm;
粳	gma
盖	gmo
羔	gmu
宫	gn;
寡	gna
惯	gno
割	gnu
怪	gnv
冈	go/
罡	goa
贵	goo
固	gou
骨	gov
购	goz
躬	gr;
皋	gra
皈	gre
盥	gro
睾	gru
鬼	grv
晷	grz
戈	gs;
媾	gse
辊	gso
轱	gsu
轧	gsv
轨	gsz
稿	gt;
缸	gta
罐	gte
刮	gtu
郜	gtv
乖	gtz
垓	gu;
赶	gua
垢	gue
鼓	guu
毂	guz
隔	gva
孤	gve
胳	gvo
肝	gvu
股	gvz
馆	gw;
鳜	gwa
觚	gwe
狗	gwo
觥	gwu
勾	gwv
够	gwz
纲	gx/
缟	gx;
纥	gxe
贯	gxo
镐	gy;
钙	gya
锆	gye
锅	gyo
钩	gyz
灰	ha/
磺	hae
厚	hao
夯	haz
憨	hb;
弧	hbe
弘	hbv
核	hc;
桓	hca
槐	hce
杭	hcz
洪	hd/
海	hd;
河	hda
浩	hde
画	hdo
湖	hdu
汉	hdv
鸿	hdz
荟	he/
荒	he;
荤	hea
荷	hee
茴	heo
葫	heu
蕙	hev
获	hez
翰	hf/
惠	hf;
卉	hfa
黄	hfo
韩	hfu
胡	hfv
魂	hge
瑚	hgu
慧	hgv
亥	hh/
豪	hha
毫	hhe
肓	hho
痕	hhv
劾	hhz
哈	hi/
哼	hi;
喊	hia
呼	hie
喝	hio
唬	hiu
吼	hiv
唤	hiz
伙	hj/
阂	hj;
辉	hja
颔	hje
货	hjo
华	hju
含	hjv
护	hk;
撼	hka
徨	hke
徽	hko
衡	hku
挥	hkv
换	hkz
谎	hl;
户	hle
祸	hlo
罕	hlu
诨	hlv
欢	hlz
烩	hm/
烘	hma
煌	hme
焊	hmo
糊	hmu
焕	hmz
豁	hn/
寒	hn;
怀	hna
慌	hne
悍	hno
恍	hnu
恨	hnv
惚	hnz
虹	hoa
蝗	hoe
幌	hoo
患	hov
航	hq;
逅	hqv
晗	hr/
遑	hr;
旱	hra
晃	hre
皇	hru
晖	hrv
毁	hrz
惑	hs;
互	hsa
划	hsu
轰	hsv
婚	hsz
禾	ht;
簧	hte
秽	hto
笏	htz
赫	hu/
壕	hu;
坏	hua
壶	huu
郝	huv
隍	hve
函	hvv
忽	hw;
猴	hwe
昏	hwo
凰	hwu
狠	hwv
缓	hx/
骇	hx;
缳	hxo
绘	hxu
幻	hxv
壑	hyu
虎	hyz
贺	hzo
仄	ia/
逐	ia;
左	iaa
斫	iae
丈	iao
砖	iau
粥	ib/
昼	ibo
桩	ic;
植	ica
株	ice
枳	ico
枝	icu
枕	icv
栅	icz
洲	id/
滓	id;
浙	ida
湛	ide
澡	ido
沾	idu
治	idv
沼	idz
芝	ie;
葬	iea
茱	iee
著	ieu
蒸	iev
遭	if;
载	ifa
政	ife
职	ifo
醉	ifu
支	ifv
酌	ifz
珍	ig/
专	ig;
琢	iga
珠	ige
责	igo
奏	igu
座	ih/
遮	ih;
状	iha
准	ihe
资	iho
章	ihu
姿	ihv
唑	ii/
踪	ii;
啄	iia
咱	iie
噪	iio
足	iiu
嘱	iiv
嘴	iiz
众	ij/
伫	ij;
值	ija
掌	ije
仲	ijo
坐	iju
仔	ijv
掷	ik/
摘	ik;
征	ika
抓	ike
捉	iko
振	iku
择	ikv
招	ikz
诊	il/
谆	il;
冢	ila
祝	ile
祖	ilo
诸	ilu
肇	ilv
诏	ilz
遵	im;
尊	ima
炸	ime
烛	imo
州	imu
郑	imv
灼	imz
灾	in/
宰	in;
怔	ina
宅	ine
宙	ino
宗	inu
赚	io/
幢	io;
置	ioa
帐	ioe
帜	ioo
则	iou
忠	iov
助	ioz
舟	iq;
爪	iqo
卮	iqv
照	ir;
皂	ira
昨	ire
追	irv
昭	irz
轸	is/
辙	is;
姊	isa
致	ise
暂	iso
臻	isu
辗	isv
赞	it/
造	it;
筑	ita
竹	ite
智	ito
制	itu
筝	itz
增	iu/
赵	iu;
圳	iue
址	iuu
志	iuv
朕	iv/
障	iv;
阵	iva
胀	ive
阻	ivo
坠	ivu
脂	ivz
炙	iw/
詹	iw;
杂	iwa
旨	iwo
猪	iwu
争	iwv
皱	iwz
纵	ix/
综	ix;
骤	ixa
缴	ixe
织	ixo
纣	ixu
缀	ixv
纸	ixz
镞	iy;
止	iya
锥	iye
钟	iyo
针	iyu
紫	iyv
铮	iyz
召	izo
厥	ja/
碱	jaa
歼	jae
碣	jao
劂	jau
厩	jav
矶	jaz
尽	jb;
既	jba
屐	jbe
局	jbo
居	jbu
建	jbv
检	jc/
杰	jc;
楷	jca
槿	jce
楫	jco
禁	jcu
橘	jcv
济	jd;
渐	jda
激	jde
溅	jdo
洁	jdu
津	jdv
汲	jdz
芥	je/
警	je;
荐	jea
敬	jee
菌	jeo
荆	jeu
茎	jev
菊	jez
柬	jf;
救	jfe
晋	jfo
基	jfu
鞠	jfz
井	jge
靓	jgo
击	jgu
珺	jgv
静	jgz
迹	jh;
减	jha
疾	jhe
竟	jho
京	jhu
郊	jhv
净	jhz
嚼	ji/
跤	ji;
距	jia
啾	jie
旧	jio
践	jiu
唧	jiv
鹃	jiz
价	jj/
仅	jj;
集	jja
介	jje
俱	jjo
剑	jju
假	jjv
隽	jjz
捡	jk/
挤	jk;
拒	jka
揪	jke
揭	jko
技	jku
径	jkv
拘	jkz
矜	jl/
鸡	jle
肩	jlo
讲	jlu
艰	jlv
劲	jlz
兼	jm;
炬	jma
爵	jmo
卷	jmv
剪	jmz
惓	jn/
惊	jn;
寄	jna
窖	jne
惧	jno
寂	jnu
窘	jnv
究	jnz
睑	jo/
蛟	jo;
贱	joa
界	joe
甲	jou
睛	jov
岌	joz
舰	jqo
斤	jqu
炅	jr/
景	jr;
臼	jra
晶	jro
舅	jrz
妗	js/
嫁	js;
戒	jsa
皆	jse
姐	jso
妓	jsu
巨	jsv
积	jt/
稼	jt;
矩	jta
矫	jte
简	jto
籍	jtu
季	jtv
笈	jtz
鉴	ju/
境	ju;
颉	jue
监	juo
坚	juu
紧	juv
均	juz
阶	jv/
胶	jv;
亟	jva
胛	jvo
际	jvu
脚	jvv
降	jvz
灸	jw/
久	jw;
獗	jwa
九	jwe
句	jwo
祭	jwu
急	jwv
角	jwz
继	jx/
绞	jx;
缰	jxa
骄	jxe
绢	jxo
绩	jxu
纪	jxv
级	jxz
镜	jy;
韭	jya
锦	jye
冀	jyo
键	jyv
钧	jyz
迦	jz;
架	jza
驾	jzv
矿	ka;
盔	kao
夸	kau
砍	kaz
垦	kbu
恳	kbv
尻	kbz
框	kca
棵	kco
枯	kcu
浍	kd/
渴	kdo
溘	kdu
蔻	ke;
苛	kea
蒯	keu
葵	kev
考	kfa
酷	kfe
聩	kfo
恐	kfv
勘	kfz
珂	kga
琨	kgo
刊	kgu
亏	kgv
廓	kh;
库	kha
颏	khe
况	kho
堃	khu
康	khv
亢	khz
哙	ki/
咳	ki;
跨	kia
喟	kio
啃	kiu
叩	kiv
侩	kj/
阔	kj;
龛	kja
侃	kjo
阚	kjv
抗	kk;
扛	kka
括	kke
扣	kko
拷	kku
揆	kkv
裤	kl;
诓	kla
癸	klu
诳	klz
炕	km;
慷	kn;
空	kna
愧	kne
宽	kno
寇	knu
慨	knv
恪	knz
髋	ko;
眶	koa
颗	koe
髁	koo
瞌	kou
瞰	kov
凯	koz
旷	kr;
昆	kra
魁	kru
暌	krv
轲	ksa
匮	kso
匡	ksu
筷	kt;
筐	kta
篑	kto
靠	ktu
坑	ku;
堪	kua
坤	kuo
壳	kuv
款	kuz
脍	kv/
胯	kva
隗	kve
孔	kvv
馗	kw/
馈	kwo
狂	kwu
纩	kx;
绔	kxa
骒	kxo
卡	ky;
锴	kya
铠	kyo
铐	kyu
龈	kyv
磷	la/
烈	la;
厉	laa
龙	lao
列	lau
碌	lav
励	laz
屡	lb/
逯	lb;
履	lbe
隶	lbo
录	lbu
楼	lc/
麓	lc;
林	lca
柳	lce
楞	lco
棱	lcu
婪	lcv
榴	lcz
粱	ld/
丽	ld;
梁	lda
涝	lde
泪	ldo
滥	ldu
浪	ldv
洛	ldz
苓	le/
莱	le;
莲	lea
莉	lee
萝	leo
蓝	leu
芦	lev
劳	lez
联	lf/
吏	lf;
栗	lfa
剌	lfu
聊	lfv
赖	lfz
玲	lg/
璃	lg;
琳	lga
璐	lgo
琅	lgv
珞	lgz
冷	lh/
凉	lh;
辣	lha
旅	lhe
露	lho
刘	lhu
率	lhv
亮	lhz
喽	li/
啦	lia
唠	lie
吕	lio
喇	liu
踉	liv
另	liz
伦	lj/
俩	lja
领	lje
侣	ljo
例	lju
邻	ljv
仑	ljz
拦	lk/
掠	lk;
拢	lka
捞	lke
揽	lku
律	lkv
撸	lkz
裣	ll/
谅	ll;
戮	lla
良	llo
垒	llu
礼	llv
烂	lm/
粒	lm;
兰	lma
炉	lme
料	lmu
粮	lmv
烙	lmz
怜	ln/
懔	ln;
懒	lna
牢	lne
帘	lno
寥	lnv
懒	lnz
岭	lo/
逻	lo;
蛎	loa
蜡	loe
略	loo
累	lov
罗	loz
晾	lr;
魉	lra
旯	lrz
轮	ls/
辘	ls;
辆	lsa
娌	lso
姥	lsu
辂	lsz
黎	lt/
笼	lta
犁	lte
箩	lto
篮	ltu
乱	ltv
埒	lu/
临	lue
览	luo
脸	lv/
辽	lv;
胧	lva
腊	lve
陆	lvu
陋	lvv
隆	lvz
鳞	lw/
獠	lwa
猎	lwe
留	lwo
鲈	lwu
狼	lwv
馏	lwz
缕	lx/
缭	lxa
骡	lxo
缆	lxu
绿	lxv
络	lxz
龄	ly/
镰	ly;
链	lya
颅	lye
锣	lyo
铑	lyu
卢	lyv
虏	lyz
冇	mao
码	mav
殁	maz
弥	mbz
买	mc;
梅	mce
木	mco
楣	mcv
梦	mcz
灭	md/
沐	mda
漠	mde
漫	mdo
沫	mdu
泌	mdv
藐	me/
茫	me;
茂	mea
摹	mee
莫	meo
蒙	meu
茅	mev
募	mez
醚	mf/
卖	mf;
酶	mfe
酩	mfz
玟	mg;
玫	mge
末	mgo
玛	mgv
麦	mgz
糜	mh/
磨	mha
摩	mhe
庙	mho
靡	mhu
氓	mhv
咪	mi/
嘛	mi;
喵	mie
黾	mio
呒	miu
骂	miv
鸣	miz
闵	mj;
闽	mjo
闷	mjv
摸	mke
扪	mko
抹	mku
拇	mkv
谜	ml/
谋	mla
谋	mle
冥	mlo
矛	mlv
祢	mlz
迷	mm;
煤	mma
貌	mme
米	mmo
迷	mmv
忙	mn;
寞	mne
蜜	mno
密	mnv
眯	mo/
虻	mo;
默	moa
瞒	moe
冒	moo
墨	mou
眠	mov
冕	moz
旻	mr;
盟	mro
昧	mru
曼	mrv
迈	ms;
媒	msa
妙	mse
嫚	mso
妹	msu
媚	msv
娩	msz
牧	mt/
秘	mt;
敏	mte
篾	mto
秒	mtu
毛	mtv
埋	muo
脉	mv;
陌	mva
膜	mve
眉	mvo
勐	mvz
猫	mwe
免	mwo
猛	mwv
勉	mwz
缅	mxa
绵	mxe
缈	mxo
糸	mxu
缪	mxv
镁	my/
锚	mye
锰	myv
铆	myz
耐	naa
奈	nau
碾	nav
尿	nbu
尼	nbz
柠	nc;
楠	ncu
泞	nd;
涅	ndo
淖	ndu
浓	ndv
泥	ndz
蔫	nea
孽	nev
聍	nf;
廿	nfa
颞	nfe
囊	nfu
酿	nfv
辇	nga
弄	nge
瑙	ngv
疟	nha
霓	nhe
凝	nhv
凝	nhz
咛	ni;
囔	nia
喏	nie
呐	nio
喃	niu
闹	nj;
倪	nje
佞	nju
您	njv
捻	nk/
拧	nk;
挠	nka
捏	nko
拈	nku
拟	nkv
农	nl;
诺	nle
讷	nlo
逆	nm;
粘	nmu
恼	nn;
懦	nna
蛲	noa
睨	noe
嬲	noo
囡	nov
男	noz
暖	nr/
曩	nr;
昵	nrv
娘	ns;
嫩	nsa
匿	nse
怒	nsv
努	nsz
牛	ntu
氖	ntz
埝	nu/
赧	nuv
脑	nv;
腻	nva
脓	nvv
鲶	nw/
袅	nw;
鸟	nwa
馁	nwe
鲇	nwu
猱	nwv
纳	nxo
纽	nxv
镊	nya
镍	nye
钠	nyo
钮	nyv
鼐	nzo
乃	nzz
碰	pa/
砰	pa;
丕	paa
硼	pav
匏	paz
辟	pb;
屁	pba
譬	pbo
劈	pbz
攀	pca
朴	pcu
杷	pcv
潘	pd/
沛	pd;
漂	pda
湃	pde
瀑	pdo
澎	pdu
婆	pdv
泼	pdz
萍	pe;
苹	pea
葩	pee
蓬	pez
瓢	pfe
聘	pfo
票	pfu
配	pfv
飘	pfz
耪	pg;
珀	pge
琶	pgv
珮	pgz
烹	ph;
庞	pha
剖	phu
霹	phv
疲	phz
趴	pi/
呯	pi;
啪	pia
啤	pie
喷	piu
噼	piv
跑	piz
凭	pje
仆	pju
僻	pjv
佩	pjz
拼	pk/
批	pka
拍	pke
扑	pku
拚	pkv
抛	pkz
谱	pl/
谝	plv
袍	plz
瓶	pma
叛	pme
贫	pmo
判	pmu
鄱	pmv
炮	pmz
怦	pn;
畔	po/
赔	po;
圃	poa
帕	poe
帔	pov
磐	pqa
爬	pqv
皤	pr/
迫	pr;
牌	pre
魄	prv
姘	ps/
嫔	ps;
嫖	psa
媲	pse
叵	pso
筢	pta
犏	ptv
篷	ptz
坪	pu;
埔	pua
彭	pue
坡	puz
胖	pv/
陪	pv;
脯	pva
脾	pve
膨	pvu
鹏	pvv
鹏	pvz
逄	pw;
匍	pwa
刨	pwu
骈	px/
辔	pxo
裴	py;
铺	pya
颦	pye
钋	pyu
颇	pze
犬	qa;
奇	qaa
牵	qae
戚	qau
砌	qaz
群	qb/
屈	qbv
枪	qc/
棋	qca
桥	qce
樯	qcu
杞	qcv
洽	qd/
泣	qd;
漆	qda
汽	qde
潜	qdo
浅	qdu
沁	qdv
沏	qdz
荃	qe/
茜	qea
擎	qee
苘	qeo
蔷	qeu
茕	qev
茄	qez
欺	qf/
裘	qf;
巧	qfa
乾	qfe
覃	qfo
鞘	qfu
娶	qfv
勤	qfz
琴	qg/
琼	qg;
球	qga
秦	qge
璩	qgu
玘	qgv
痊	qh/
庆	qha
齐	qhe
癯	qho
敲	qhu
妾	qhv
瘸	qhz
呛	qi/
跷	qia
吣	qiv
阙	qj/
衾	qj;
倾	qja
侨	qje
禽	qjo
企	qju
侵	qjv
阕	qjz
擒	qk/
撬	qke
衢	qko
掮	qkv
掐	qkz
谦	ql/
谴	ql;
祺	qla
祈	qle
启	qlo
祛	qlu
裙	qlv
劝	qlz
遒	qm;
酋	qma
拳	qme
羌	qmv
歉	qmz
恰	qn/
寝	qn;
窃	qna
憔	qne
悄	qnu
穹	qnv
穷	qnz
圈	qo/
遣	qo;
曲	qoa
瞧	qoe
峭	qou
岂	qov
颀	qqe
躯	qr/
丘	qra
泉	qru
邱	qrv
区	qs/
顷	qse
堑	qsu
妻	qsv
秋	qt/
迁	qt;
签	qta
乔	qte
氰	qtu
缺	qtv
趣	qua
罄	que
墙	quu
趋	quz
腔	qv;
戕	qva
阡	qve
朐	qvz
鳅	qwe
鳍	qwu
卿	qwv
绻	qx/
驱	qxa
纤	qxe
缱	qxo
铨	qy/
虔	qy;
钳	qya
铅	qye
觑	qyo
歧	qyu
镪	qyv
钦	qyz
辱	raa
碍	rao
厄	rav
屙	rbv
桉	rc;
溶	rd;
染	rda
澳	rde
润	rdo
汝	rdv
艾	re/
蓉	re;
荣	rea
荏	ree
芮	reo
藕	reu
惹	rev
鞍	rf;
耳	rfa
噩	rfo
垩	rfu
恶	rfv
鏊	rg/
熬	rg;
獒	rga
敖	rge
瑞	rgo
遨	rgv
韧	rgz
鏖	rh/
霭	rh;
庵	rha
哀	rhe
癌	rho
霭	rhv
哎	ri/
嚷	ri;
呕	ria
哦	rie
嗯	rio
嗷	riu
唉	riv
儒	rj;
仁	rja
俄	rje
偶	rjo
傲	rju
仞	rjz
按	rk;
扰	rka
摁	rko
挨	rkv
扔	rkz
谙	rl;
柔	rla
袄	rle
谔	rlo
诶	rlv
冗	rlz
熔	rm;
乳	rmv
燃	rmz
怄	rna
额	rne
案	rnv
肉	ro/
黯	ro;
岸	roa
盎	roo
恩	rov
暧	rr/
暗	rr;
奥	rra
皑	rro
翱	rrv
昂	rrz
戎	rsa
娥	rse
贰	rsu
欧	rsz
氨	rt;
壬	rta
矮	rte
鹅	rtz
壤	ru;
埃	ruv
坳	ruz
隘	rv/
孺	rv;
孺	rva
腭	rvo
阮	rvu
迩	rw;
饶	rwa
饿	rwe
鳄	rwo
尔	rwu
绒	rxa
纫	rxz
锐	ry/
镕	ry;
睿	ryo
刃	rz;
爽	sa/
碎	sa;
厦	saa
殊	sae
石	sao
奢	sau
耍	sav
屎	sb/
肃	sb;
尸	sbe
属	sbo
刷	sbu
巳	sbv
松	sc/
述	sc;
森	sca
杉	sce
梢	scu
树	scv
溯	sd/
裟	sd;
洒	sda
沈	sde
湿	sdo
沙	sdu
沈	sdv
涩	sdz
莎	se;
菘	sea
薯	seo
蒜	seu
萨	sev
苏	sez
甚	sf/
速	sf;
丧	sfa
散	sfe
束	sfo
索	sfu
酸	sfv
琐	sg/
寿	sga
示	sgu
素	sgv
珊	sgz
熟	sh;
霜	sha
施	she
市	sho
率	shu
瘦	shv
孰	shz
啥	si/
噻	si;
嘶	sia
噬	sie
虽	sio
哨	siu
嗓	siv
跚	siz
闪	sj/
食	sj;
耸	sja
伤	sje
尚	sjo
什	sju
似	sjv
倏	sjz
授	sk/
誓	sk;
摄	ska
搜	ske
损	sko
捎	sku
扫	skv
势	skz
识	sl/
诗	sl;
试	sla
谁	sle
视	slo
社	slu
双	slv
设	slz
燧	sm/
送	sm;
杀	sma
首	sme
善	smo
塑	smu
释	smv
烁	smz
赛	sn/
邃	sn;
守	sna
宿	sne
审	sno
室	snu
瞬	so/
蛇	so;
髓	soa
睡	soe
史	soo
申	sou
思	sov
岁	soz
帅	spo
艘	sqe
射	sra
顺	sre
曙	sro
暑	sru
鼠	srv
匙	srz
输	ss/
婶	ss;
轼	ssa
嫂	sse
始	ssv
姗	ssz
税	st/
适	st;
穗	sta
牲	ste
失	sto
升	stu
私	stv
舐	stz
竖	su;
寺	sua
赦	sue
螫	suo
士	suu
肾	suv
隧	sv/
胜	sv;
隋	sva
收	sve
腮	svo
孙	svu
鳝	sw/
煞	sw;
夙	swa
饰	swe
蚀	swo
狮	swu
氏	swv
缮	sx/
缩	sx;
丝	sxa
驶	sxo
纱	sxu
骚	sxv
绍	sxz
铈	sy;
锼	sye
锁	syu
叔	syv
铯	syz
邵	szv
劭	szz
砼	ta/
砣	ta;
厅	taa
碳	tao
套	tav
弹	tb/
屉	tba
屉	tbe
屠	tbu
臀	tbv
梯	tc/
檀	tc;
柝	tce
桐	tco
桶	tcv
涂	td/
潼	td;
潭	tda
淘	tde
湍	tdo
涛	tdu
滩	tdv
汤	tdz
荼	te/
葶	te;
荑	tea
茼	teo
藤	tev
萄	tez
酡	tf;
酞	tfa
酮	tfo
忑	tfv
韬	tg/
焘	tg;
替	tgo
泰	tgu
痰	th/
亭	tha
庭	the
童	tho
唐	thv
疼	thz
跳	ti/
啼	ti;
呔	tia
唾	tie
踢	tio
吐	tiu
叹	tiv
啕	tiz
偷	tj/
停	tj;
仝	tja
贪	tjo
堂	tju
途	tjv
佟	tjz
挑	tk/
推	tk;
探	tka
托	tke
徒	tku
抬	tkv
投	tkz
讨	tla
袒	tlo
褪	tlv
糖	tm;
誊	tmo
剃	tmu
妥	tmv
鹈	tmz
悌	tn/
突	tna
恬	tne
惕	tno
恸	tnu
眺	to/
瞳	to;
田	toa
蜓	toe
峒	too
贴	tou
暾	tr;
躺	tru
婷	ts;
屯	tsv
毯	tt/
透	tt;
甜	tta
颓	tte
筒	tto
舔	ttu
廷	ttv
秃	ttz
填	tu/
塘	tu;
土	tua
塔	tue
坦	tuo
趟	tuu
坛	tuv
坍	tuz
腾	tv/
腿	tv;
豚	tva
胴	tvo
膛	tvu
胎	tvv
陶	tvz
鸵	tw;
饨	twa
彤	twe
兔	two
獭	twz
驼	tx;
缇	txo
绦	txz
锑	ty/
铊	ty;
钛	tya
铜	tyo
镗	tyu
龆	tyz
迢	tz;
帑	tzo
碗	wa;
歪	waa
戊	wae
兀	wav
尉	wba
尾	wbe
慰	wbv
梧	wca
枉	wcu
桅	wcz
湾	wd;
汪	wda
沃	wde
涡	wdo
污	wdu
渥	wdv
蕹	we;
葳	wea
薇	wee
苇	weu
蔚	wev
斡	wf/
巫	wfa
吾	wfo
卧	wfu
恶	wfv
违	wg;
玩	wga
顽	wge
未	wgo
韦	wgu
鹉	wgz
忘	wh;
弯	wha
痿	whe
瘟	who
紊	whu
亡	whv
雾	whz
嗡	wi/
吴	wia
唯	wie
喂	wio
味	wiu
喔	wiv
吻	wiz
伪	wj/
伪	wj;
闻	wja
侮	wje
偎	wjo
伟	wju
挖	wk;
捂	wka
微	wko
握	wkv
挽	wkz
诬	wla
诿	wle
误	wlo
袜	wlu
骛	wlv
鹜	wlz
烷	wm;
瓮	wma
煨	wmo
炜	wmu
翁	wmv
惋	wn;
悟	wna
惟	wne
窝	wno
剜	wnu
寤	wnv
宛	wnz
罔	wo/
蚊	wo;
畏	woa
巍	woe
蜗	woo
围	wou
胃	wov
皖	wr;
晤	wra
魍	wro
旺	wru
瓦	ws;
娲	wso
娃	wsu
娓	wsv
婉	wsz
舞	wt;
牾	wta
魏	wte
午	wtu
委	wtv
稳	wtz
圩	wuu
坞	wuz
腕	wv;
阢	wva
丸	ww;
乌	wwa
勿	wwe
猥	wwo
刎	wwu
危	wwv
纹	wx;
毋	wxe
纬	wxu
纨	wxz
钨	wye
袭	xa;
厢	xaa
夏	xao
硝	xau
殉	xaz
迅	xb;
犀	xbe
痫	xbo
屑	xbu
校	xc;
械	xca
析	xce
杏	xco
楔	xcu
栩	xcv
橡	xcz
溪	xd/
渲	xd;
湘	xda
洗	xde
瀣	xdu
泻	xdv
洵	xdz
蓄	xe;
蕈	xea
薛	xee
血	xeo
荥	xeu
萧	xev
荀	xez
熙	xf;
献	xfa
项	xfe
醒	xfo
鞋	xfu
孝	xfv
协	xfz
璇	xg;
顼	xge
型	xgu
邢	xgv
庠	xh/
序	xh;
需	xha
效	xhe
席	xho
辛	xhu
雪	xhv
癣	xhz
喧	xi;
吓	xia
响	xie
嚣	xio
吁	xiu
啸	xiv
吸	xiz
斜	xj;
休	xja
仙	xjo
削	xju
叙	xjv
修	xjz
徐	xk/
挟	xk;
循	xke
踅	xko
徙	xku
徇	xkz
详	xl/
戏	xl;
习	xla
谢	xle
袖	xlo
训	xlu
讯	xlv
询	xlz
烯	xm/
兮	xma
熄	xme
籼	xmo
凶	xmv
穴	xn/
宣	xna
惜	xne
惺	xno
宵	xnu
懈	xnz
峡	xo;
兄	xoe
蝎	xoo
黠	xou
县	xov
峋	xoz
舷	xq;
欣	xqz
衅	xr/
暄	xr;
晓	xra
星	xre
显	xru
暇	xrv
歇	xrz
嫌	xs/
辖	xs;
姓	xse
匣	xso
轩	xsu
邪	xsv
稀	xt/
选	xt;
箱	xta
香	xto
卸	xtv
秀	xtz
幸	xu/
熹	xu;
馨	xue
贤	xuo
墟	xuu
险	xv/
逊	xv;
膝	xva
陷	xve
腥	xvo
隙	xvu
限	xvv
胸	xvz
鲜	xw/
夕	xw;
枭	xwa
饷	xwe
旬	xwo
玺	xwu
匈	xwv
馅	xwz
飨	xx/
巡	xx;
骁	xxa
乡	xxe
细	xxo
续	xxu
绚	xxz
鑫	xy/
镶	xy;
虚	xya
锈	xye
锡	xyo
销	xyu
勰	xzo
尤	ya;
硬	yaa
愿	yae
右	yao
研	yau
友	yav
熨	yb/
异	yba
尹	ybe
聿	ybu
痈	ybz
榆	yc/
椅	yca
樱	yco
樾	ycu
乙	ycv
杨	ycz
洋	yd/
演	yd;
源	yda
渊	yde
油	ydo
沅	ydu
泳	ydv
沿	ydz
荧	ye/
页	ye;
芽	yea
莠	yee
营	yeo
莹	yeu
艺	yev
药	yez
雨	yf;
亚	yfa
严	yfe
燕	yfo
酝	yfu
耶	yfv
瑶	yg/
迂	yg;
琊	yga
元	yge
玉	ygo
耘	ygu
云	ygv
艳	ygz
痒	yh/
亦	yh;
弈	yha
夜	yhe
衣	yho
育	yhv
韵	yhz
吟	yi/
咬	yi;
呀	yia
跃	yie
员	yio
叶	yiu
咏	yiv
阅	yj/
仪	yj;
优	yja
攸	yje
仪	yjo
余	yju
愈	yjv
仰	yjz
摇	yk/
衍	yk;
掩	yka
御	yke
押	yko
拥	ykv
扬	ykz
议	yl/
永	yl;
讶	yla
预	yle
翼	ylo
予	ylu
译	ylv
勇	ylz
炎	ym/
遥	ym;
肴	yma
养	yme
益	ymo
羊	ymu
爷	ymv
欲	ymz
悦	yn/
誉	yn;
忧	yna
窑	yne
宜	yno
宇	ynu
忆	ynv
蚁	yo/
遇	yo;
因	yoa
屹	yoe
圆	yoo
园	you
野	yov
鸭	yoz
舆	yr/
邀	yr;
晕	yra
映	yro
曰	yru
延	yrv
昀	yrz
姚	ys/
雅	ys;
姨	ysa
医	yse
姻	yso
妍	ysu
郾	ysv
鸦	ysz
氧	yt/
夭	yt;
氩	yta
筵	yte
秧	yto
竽	ytu
懿	yu;
越	yua
袁	yuo
垠	yuv
院	yv;
腰	yva
腴	yve
阳	yvo
阴	yvv
隐	yvz
馀	yw/
迎	yw;
犹	ywa
颖	ywe
鱼	ywo
猿	ywu
印	ywv
饮	ywz
验	yx/
幺	yx;
绮	yxa
缨	yxo
纭	yxu
缘	yxv
幼	yxz
镒	yy/
铱	yy;
虞	yyo
钰	yyu
钥	yyv
盈	yzo
因为	y;
殡	ba;e
礴	bae;
砭	baev
飙	baz/
璧	bbu;
剥	bbuu
槟	bc;e
彬	bcae
柄	bcau
彬	bcee
柏	bceu
梆	bcuv
滨	bd;/
灞	bd;e
汴	bd;u
滗	bdea
浜	bdeu
濒	bdue
蕃	be/o
蒡	be;;
菠	be;z
荜	beav
蓓	bee;
蓖	beeu
荸	beuv
鬓	bf;e
逋	bf;v
髟	bfee
孛	bfva
邴	bfvv
耙	bgvu
斌	bhaa
庇	bhav
瘪	bhe/
瓣	bhe;
亳	bhea
褒	bheu
痹	bhoa
卞	bhu;
斌	bhua
癍	bhuu
疤	bhvu
哺	biau
哔	biav
呗	bio/
趵	biz;
煲	bj/o
傍	bj;;
傧	bj;e
佰	bjao
俾	bjeu
卜	bjoo
俵	bjue
扒	bk//
掰	bk/e
拌	bk/u
揄	bk/v
扮	bk/z
搏	bkaa
搏	bkau
拔	bkav
扳	bkee
捭	bkeu
捌	bkou
摒	bkv/
拨	bkz;
彼	bkzv
谤	bl;;
祊	bl;v
褓	bleo
裱	blue
焙	bm;o
炳	bmau
敝	bmea
蹩	bmou
憋	bmv;
煸	bmvo
粑	bmvu
鳖	bmzo
愎	bnea
贬	boe;
睥	boeo
髀	boeu
蚌	bouu
舨	bqee
晡	brau
魃	brav
曝	broe
帛	brou
卑	bruu
妣	bsav
婊	bsue
箔	bt;e
簸	btau
筚	btav
犇	btea
篦	bteo
坂	buee
膑	bv;e
膘	bvau
陛	bvav
飚	bw//
鳔	bwau
狈	bwo/
鳊	bwvo
鸨	bwza
鲍	bwzv
绊	bx/u
骉	bxvv
镑	by;;
镔	by;e
钚	bya;
锛	byaa
镖	byau
钹	byav
钣	byee
铂	byeu
悲	byv;
铋	byve
钯	byvv
磋	ca/u
碴	caao
蹙	cao;
殂	caoa
厕	caou
辰	cau;
唇	cauo
碜	cava
孱	cbvv
村	cca;
橱	ccaa
楂	ccao
槽	ccau
郴	ccav
杵	ccea
橙	ccv/
杈	ccv;
椽	ccvv
澶	cd;o
淬	cd;u
淳	cd;v
涔	cdo/
豉	cduv
滁	cdv/
潺	cdva
澄	cdvo
菜	ce/a
苍	ce/v
茨	ce;z
茬	ceau
菖	ceoo
蔡	cezu
酬	cf/u
裁	cf;;
醇	cf;v
敕	cfea
耻	cfua
矗	cfuo
矗	cfuu
翅	cfvv
蚕	cgo;
瓷	cha;
瓷	chav
颤	che/
痴	cheo
畜	choo
疵	chuv
蹭	ci/o
蹴	ci;a
蹿	ci;o
啐	ci;u
嚓	ci;z
嘈	ciao
喳	ciau
躇	cieu
喘	cioa
嗤	cioo
呈	ciua
哧	ciue
嗔	ciuo
嘲	ciuv
呲	ciuz
啜	civv
叱	cizz
氅	cjea
伥	cjeu
催	cjoe
倡	cjoo
促	cjou
俦	cjua
倘	cjuo
偿	cjuu
尝	cjuv
伺	cjvo
储	cjvu
闯	cjvv
侈	cjzz
搓	ck/a
撤	ck;e
搐	ck;o
撺	ck;u
搽	cke/
捶	ckea
拆	ckee
措	ckeo
揣	ckoa
摧	ckoe
操	ckoo
抻	ckou
撮	ckov
扯	ckua
抄	ckue
掺	ckva
搀	ckz;
谶	cl/a
诧	cl;e
翠	cl;u
衬	clau
戳	clav
谌	cle/
褚	cluo
衩	clv;
谗	clz;
谄	clze
皴	clzv
豺	cmau
糙	cme;
炽	cmo/
肏	cmo;
灿	cmoo
岔	cmou
刹	cmuu
兹	cmvv
岔	cmzo
怆	cn/v
悰	cn;u
怵	cna;
宸	cnaa
惭	cnae
慒	cnao
忖	cnau
怅	cnea
忏	cneu
忡	cnou
忱	cnve
蝉	co/o
蜍	co/u
岑	co/v
贮	co;a
幢	co;o
崇	co;u
瞅	coea
黜	coou
畴	coua
瞠	couo
艟	cq;o
侪	cr;e
魑	cr;o
臭	cra;
虿	cso;
邨	csvu
簇	ct;e
秤	ct;u
垂	ctaa
氚	cteu
篡	ctoa
筹	ctua
	ctva
笞	ctvo
稠	ctzu
丞	cvaa
肠	cvze
猝	cw;u
馇	cwau
舛	cwav
饬	cwea
鲳	cwoa
猖	cwoo
删	cwuu
骋	cxoa
粲	cy/;
锉	cy/u
齿	cy/v
铳	cy;e
雌	cye;
锤	cyea
钏	cyeu
龊	cyou
钗	cyv;
碇	da;a
礅	da;e
碟	daaa
耷	daau
碓	daeu
砥	daz;
碉	dazu
椟	dcu;
档	dcuv
淀	dd;a
渡	dd;e
逗	dd;v
沓	ddoo
滇	dduo
蒂	de;o
耵	dfau
耋	dfav
颠	dfe/
聃	dfo;
靼	dfoa
蠹	dfoo
痘	dhao
疔	dhau
瘩	dhe/
疸	dhoa
盗	dhoo
帝	dhou
癫	dhue
啖	di//
蹈	di/e
嗲	di/z
嘀	di;o
踮	di;u
哒	dia;
叮	diau
吨	diav
嗒	die/
嘚	dieo
噔	div/
叼	diva
咚	diz;
跺	diza
哆	dizz
仃	djau
黛	djo;
佃	djoa
侗	djoo
掂	dk;u
掉	dkua
垫	dkuu
挡	dkuv
掇	dkvv
捣	dkzo
褡	dle/
谍	dlea
怠	dlov
祷	dlua
裆	dluv
怼	dlv;
裰	dlvv
诋	dlz;
奠	dmao
炖	dmav
兑	dmee
郸	dmvu
羝	dmz;
貂	dmzo
惇	dn;o
宕	dnao
窦	dnu;
悼	dnua
睇	do/v
瞪	do;a
蚪	do;u
盹	doav
黩	dou;
巅	doue
睹	douo
瞪	dov/
眈	dovv
舵	dq;z
牒	drea
妲	dsoa
氮	dt//
氘	dteu
犊	dtu;
丢	dtv;
坫	duua
腚	dv;u
蛋	dvo;
堕	dvua
陡	dvuu
氐	dw;;
丹	dw;a
甸	dwoo
岛	dwou
剁	dwuu
锭	dy;a
镝	dy;o
钝	dyav
铤	dyea
钿	dyoa
镫	dyv/
梵	fcz;
汾	fd/z
淝	fdvv
藩	fe;e
芾	fe;o
菲	feua
敷	ffea
麸	fgu;
奉	fguu
珐	fguv
痱	fhua
疯	fhz/
呋	fiu;
俯	fj;e
伏	fja;
俸	fjaa
阈	fjao
傅	fjau
伐	fjav
抚	fkuv
讣	flu;
粪	fme/
斧	fmee
忿	fmv;
孚	fmvu
乏	fmvv
分	fmzz
悱	fnua
罘	foa;
蝠	foao
帆	foz;
蜂	fozu
舫	fq;v
辐	fsao
馥	ftea
筏	fteu
氟	ftvu
坊	fu;v
腑	fv;e
肺	fv;o
肪	fv;v
腹	fvea
腹	fveo
腓	fvua
逢	fw;v
鲱	fwua
凤	fwv;
狒	fwvu
龚	gae/
槁	gc;o
梗	gca;
杠	gcau
梏	gcea
杆	gcuu
枸	gczo
灌	gdeo
汩	gdoo
洸	gdue
耿	gf//
甘	gfaa
聒	gfea
贡	gfo/
瞽	gfoo
恭	gfu;
巩	gfz;
鸪	gfza
珙	gge/
耕	ggue
珪	gguu
衮	gheu
赓	gho/
痼	ghou
膏	ghov
庚	ghv;
庚	ghva
膏	ghvv
嗝	giao
哽	giau
啯	giou
咣	giue
剐	giuu
咯	gizo
仡	gjea
刽	gju;
闺	gjuu
鸽	gjza
伽	gjzo
掼	gkoo
掴	gkou
拐	gkoz
擀	gku/
诰	glea
诟	glee
诂	gluo
褂	gluu
糕	gm/;
羹	gm/u
虢	gmuz
炔	gmv;
宫	gnoo
蚣	go/v
赅	go;/
岗	goo/
帼	goo;
蛊	gooa
崮	gooo
刿	gouu
鹘	goza
骼	gozo
躬	grvv
臵	gszo
篙	gt;o
箍	gtau
篝	gteo
牯	gtuo
竿	gtuu
乖	gtuz
鹄	gtza
埂	guau
圪	guea
卦	guu;
圭	guua
膈	gvao
肛	gvau
肱	gvav
胱	gvue
胳	gvzo
犷	gw;e
逛	gw;v
鳏	gwou
龟	gwov
鲑	gwuu
狗	gwzo
纲	gxo/
锢	gyou
铬	gyzo
憨	hbv;
杭	hc;z
桦	hceu
濠	hd;a
浒	hd;e
浣	hd;u
汇	hdav
洪	hde/
淮	hde;
海	hdea
潢	hdeo
混	hdoa
灏	hdoe
涸	hdou
滑	hdov
瀚	hdu/
汗	hduu
浑	hdva
沪	hdve
涵	hdvu
泓	hdvv
涣	hdzo
藿	he;e
蒿	he;o
蕙	heav
蘅	heez
薨	heoa
菡	hevv
酣	hfaa
鬟	hfoo
惠	hfv;
邯	hfvu
耗	hgea
璜	hgeo
琥	hgua
珲	hgv;
彗	hgva
霍	hhe;
麾	hhea
瘊	hhev
肓	hhva
亨	hhvv
痪	hhzo
呼	hi/u
嚯	hi;;
嚎	hi;a
嗨	hi;e
呵	hiau
哄	hie/
嗬	hiee
嗥	hieo
哗	hieu
喉	hiev
嘿	hio;
踝	hioo
喙	hivv
颌	hje/
盒	hjoo
阖	hjuo
辉	hjva
侯	hjve
捍	hkoa
徊	hkoo
护	hkve
衡	hkzu
诃	hlao
讧	hlau
谎	hle;
诲	hlea
扈	hlov
褐	hloz
祜	hluo
讳	hluu
鹤	hlza
豢	hma;
烘	hme/
煳	hmuv
恢	hna/
憾	hna;
恒	hnao
宦	hnau
宏	hnav
悔	hnea
惶	hneo
寰	hnoe
怙	hnuo
骸	ho;/
虾	hoau
贿	hoav
蚶	hoea
骺	hoee
圜	hooa
蛔	hooo
逅	hq;v
颢	hre;
晦	hrea
皓	hreo
昊	hru;
晃	hrue
鼾	hruu
曷	hrz/
齁	hrzo
馄	hsoa
嬛	hsoo
惑	hsv;
氦	ht;e
赫	huu/
恚	huv;
斛	hw;u
狐	hwee
獾	hweo
凰	hweu
奂	hwo;
猾	hwov
猢	hwuv
绘	hx/u
砸	iaao
臧	iaau
砧	iaua
殖	iauo
咫	ibo/
帚	ibou
梓	ic;/
柱	ic;a
榨	ic;e
樟	ic;o
棕	ic;u
杖	ica;
柘	icao
桎	icau
椎	ice;
栀	icee
栉	icev
栈	icu;
桢	icua
榛	icue
植	icuo
杼	icv;
札	icvv
滋	id/v
漳	id;o
湛	ida/
涿	ida;
渣	idao
滞	idau
洙	idea
浊	ido;
渍	idu/
渚	iduo
汁	iduu
濯	idv;
涨	idva
淄	idvo
泽	idvu
潴	idzu
蔗	ie;;
藻	ie;o
蘸	ieau
芷	ieua
茁	ievv
枣	if;;
鬃	if;a
醉	if;u
甄	ifa;
栽	ifau
酢	ifea
煮	ifo;
哉	ifoo
酯	ifzo
璋	ig;o
瓒	igea
赘	igo/
盏	igoo
瑱	iguo
疹	ih/e
卒	ih/u
瘴	ih;o
震	ihaa
斋	ihao
症	ihau
族	ihea
彰	ihee
衷	ihoe
咨	ihoo
章	ihou
庄	ihua
壮	ihuu
痣	ihuv
恣	ihv;
妆	ihve
咤	ii;e
跖	iiao
咂	iiav
咋	iiea
唣	iieo
吒	iiev
咀	iioa
躁	iioo
嘬	iiov
啧	iiu/
趾	iiua
吱	iiuv
啁	iizu
咒	iizz
僮	ij;o
仗	ija;
佐	ijaa
侄	ijau
俎	ijoa
闸	ijou
帧	iju/
侦	ijua
债	ijuo
拄	ik;a
撞	ik;o
挝	ika;
振	ikau
挚	ikea
折	ikee
攒	ikeo
攥	ikeu
蛰	iko;
徵	ikoe
哲	ikoo
拽	ikov
揍	ikuu
擢	ikv;
拯	ikva
撰	ikve
摺	ikvo
拙	ikvu
扎	ikvv
执	ikz;
鸷	ikza
挣	ikzv
谪	il;o
翟	ile;
诛	ilea
诈	ileu
蚤	ilo;
诅	iloa
祝	iloe
祉	ilua
褶	ilve
祗	ilz;
鸩	ilza
诤	ilzu
诌	ilzv
兆	im;;
炷	im;a
粽	im;u
糟	imao
繇	imev
炽	imo/
燥	imoa
燥	imoo
粘	imuo
灶	imuu
兹	imv;
孳	imvu
籽	imvv
憎	in/o
寨	inau
窒	inav
窄	inea
惴	inoa
祯	inua
赠	io/o
眨	io/v
贮	io;a
赃	io;u
贼	ioa;
赈	ioaa
蛭	ioau
崭	ioav
颛	ioe/
蛛	ioe;
账	ioea
蚱	ioeu
眨	ioev
盅	iooa
崽	ioov
峙	iou;
罪	ioua
罩	iouo
胄	iova
瞩	iove
瞻	ioz;
睁	iozv
追	ir;v
侏	ireu
錾	is/a
辄	isau
斩	isee
轴	isoa
轴	isoo
匝	isou
辎	isvo
郅	isvu
朱	it;;
箴	ita;
乍	itaa
簪	itao
稚	ite;
秩	itea
笊	itee
雉	iteu
秭	itev
赞	ito/
租	itoa
纂	itov
稹	itu/
毡	itua
箸	ituo
竺	ituu
篆	itv;
赵	iu/;
凿	iu/v
赭	iuue
喆	iuuo
胗	iv/e
膣	iv;a
脏	iv;u
奘	iva;
肘	ivau
孜	ivea
肿	ivou
肢	ivuv
鳟	iw/a
兆	iw;;
獐	iw;u
猹	iwau
昝	iwoo
鲭	iwuv
馔	iwve
邹	iwvv
缯	ix/o
绽	ix;a
驻	ix;u
骓	ixe;
缜	ixuo
绰	ixuu
缁	ixvo
绌	ixvu
绉	ixzv
镇	iyao
桌	iyau
铢	iyea
贞	iyo/
占	iyoo
铡	iyou
镯	iyoz
铸	iyua
钻	iyuo
卓	iyuu
龇	iyuv
硷	ja/a
礓	jaao
礁	jae;
疆	jbao
犟	jbea
届	jboa
君	jboo
剧	jbuu
忌	jbv;
郡	jbvu
橛	jca/
柩	jcav
桔	jcuo
椒	jcuv
枷	jczo
浃	jd;;
酒	jdau
浇	jdav
湫	jdea
沮	jdoa
涧	jdou
涓	jdov
泾	jdva
浸	jdvv
浚	jdvz
茭	je;/
荚	je;;
荠	je;e
菅	je;v
蒋	je;z
蕨	jea/
菁	jeaa
苣	jeav
蕉	jee;
茧	jeo;
苋	jeoe
莒	jeoo
藉	jeue
葭	jevv
芨	jez;
茄	jezo
蓟	jezu
棘	jfau
戟	jfav
截	jfe;
靳	jfee
聚	jfeu
贾	jfo/
觐	jfoe
兢	jfue
髻	jfuo
酵	jfuv
瑾	jgeo
珏	jgu;
井	jguu
玖	jgz;
珈	jgzo
玑	jgzv
疥	jh/e
瘠	jh/v
夹	jh;;
霁	jh;e
奖	jha;
酱	jhao
桨	jhau
颊	jhe/
旌	jhea
齑	jheu
疽	jhoa
竞	jhoe
竭	jhoz
浆	jhu;
剂	jhuu
靖	jhuv
痉	jhva
疖	jhvu
脊	jhvv
竣	jhvz
疚	jhz;
鹫	jhza
痂	jhzo
嗟	ji/a
跻	ji;e
蹶	jia/
噘	jia;
噤	jiau
喈	jiav
噱	jiua
咭	jiuo
踞	jivu
叽	jizz
俭	jj/a
倦	jj/v
佼	jj;/
焦	jj;;
侥	jjaa
僵	jjao
僭	jjav
牮	jjea
儆	jjee
借	jjeo
觎	jjoe
偈	jjoz
佶	jjuo
佳	jjuu
伎	jjuv
仅	jjv;
倨	jjvo
倔	jjvu
健	jjvv
俊	jjvz
阄	jjzo
挟	jk;;
搅	jk;o
撅	jka/
拣	jka;
捷	jkav
攫	jko;
捐	jkov
拮	jkuo
街	jkuu
抉	jkv;
掘	jkvv
掬	jkz/
衿	jl/v
谏	jla;
诫	jlaa
襟	jlau
诫	jlav
颈	jle/
谨	jleo
诘	jluo
讦	jluu
诀	jlv;
诀	jlva
谲	jlvo
裾	jlvu
肩	jlvv
鸡	jlza
皲	jlzv
讥	jlzz
煎	jm;;
桀	jmau
眷	jmoa
炯	jmoo
羯	jmoz
烬	jmv;
焗	jmva
姜	jmve
翦	jmvv
悸	jnea
憬	jno;
蹇	jnou
囧	jo/v
迥	jo;v
畸	joaa
睫	joav
瞿	joe;
羁	joev
贱	jou;
巾	jouu
睛	jouv
囝	jova
崛	jovv
峻	jovz
皎	jr;/
舅	jroz
姣	js;/
嫉	js;e
姬	jsau
婕	jsav
娇	jsea
匠	jsee
轿	jseu
辑	jsoa
娟	jsov
奸	jsuu
婧	jsuv
箭	jt/v
榘	jta;
犄	jtaa
嵇	jtao
箕	jtau
稽	jtaz
积	jto/
笕	jtoe
稷	jtoz
笺	jtu;
秸	jtuo
筠	jtuz
毽	jtva
犍	jtvv
筋	jtvz
笳	jtzo
吉	juoo
赳	juvu
圾	juz;
嘉	juzo
劫	juzz
孓	jv;;
阱	jvuu
脚	jvuv
腱	jvv;
胫	jvva
肌	jvzz
饺	jw;/
狡	jw;;
鲸	jw;u
飓	jwo/
狙	jwoa
咎	jwoo
狷	jwov
饯	jwu;
鲫	jwvv
鸠	jwza
饥	jwzz
缄	jxao
缙	jxau
缴	jxee
缉	jxoa
骥	jxua
剿	jxuu
纠	jxvv
骏	jxvz
驹	jxzo
绛	jxzv
铰	jy;/
镓	jy;a
遽	jy;v
镢	jya/
钜	jyav
镌	jyeu
锏	jyoo
钾	jyou
锔	jyvo
锯	jyvu
乩	jyvv
磕	kauo
奎	kauu
柯	kcau
槛	kcuo
溃	kdoo
髡	kfav
疴	khau
邝	khvu
喀	ki;o
吭	ki;z
哐	kiav
咔	kiua
嗑	kiuo
跬	kiuu
侉	kjau
郐	kjvu
扩	kk;e
抠	kka/
挎	kkau
揩	kkav
捆	kkoa
糠	km;v
忾	knea
宽	kneo
窠	kno;
悝	knoa
愦	knoo
恺	knov
窥	knuo
窟	knvv
困	koa;
蝰	koau
骷	kouo
岿	kouv
睽	kovu
魁	kr;u
犒	kt;o
稞	kto;
氪	ktuo
逵	ku;v
坷	kuao
垮	kuau
坎	kuz/
壳	kuzz
狯	kw/u
鲲	kwoa
钶	kyau
锞	kyo;
铿	kyuu
殓	la/a
砬	la;a
硫	la;e
裂	la;o
磊	laaa
聋	laau
砺	laav
厘	laoa
垄	lauu
砾	laz;
鹩	laza
尥	lazo
栏	lc/a
榈	lcoo
榄	lcuo
棂	lcv/
榔	lcvv
橹	lczo
柳	lczv
鎏	ld/a
潋	ld/e
泠	ld/v
沦	ld/z
濂	ld;/
涞	ld;;
漉	ld;a
漓	ld;o
浏	ld;u
逦	ld;v
涟	lda;
淋	ldaa
潦	ldao
沥	ldaz
丽	ldo;
澜	ldoa
泸	ldua
滤	lduv
漏	ldva
郦	ldvu
泺	ldz;
鹂	ldza
溜	ldzo
蕾	le;o
藜	lee/
莅	lee;
荦	leea
蔺	leoe
菱	leuz
蓼	lev/
荔	lezz
酹	lf/a
聆	lf/v
酪	lfzo
聊	lfzv
勒	lfzz
耧	lg/v
耒	lg;;
琉	lg;e
琅	lg;v
珑	lga;
琏	lgav
六	lh//
廉	lh/;
銮	lh/a
廖	lh/e
零	lh/v
麟	lh/z
凛	lh;o
癞	lha/
霖	lhaa
栾	lhau
鹿	lhav
雳	lhaz
挛	lhea
痢	lheu
痨	lhez
赉	lho/
脔	lho;
斓	lhoa
雷	lhoo
峦	lhou
羸	lhov
冽	lhuu
凌	lhuz
廖	lhv/
恋	lhv;
孪	lhva
庐	lhve
疗	lhvu
廊	lhvv
癃	lhvz
鸾	lhza
瘤	lhzo
呤	li/v
咙	lia;
嘹	liao
咧	liau
躏	lieo
嘞	liez
哩	lioa
啰	lioz
唳	liva
啷	livv
鹭	liza
噜	lizo
伶	lj/v
阑	lja;
俪	ljao
僚	ljau
敛	ljea
俐	ljeu
赁	ljo/
儡	ljo;
俚	ljoa
闾	ljoo
佬	ljuv
翎	ljvv
绺	ljzo
拎	lk/;
捋	lk/a
搂	lk/v
抡	lk/z
擂	lk;o
撩	lkao
摞	lkou
撂	lkoz
掳	lkuz
捩	lkva
戾	llao
裢	llav
裸	llo;
谰	lloa
褛	llov
褴	lluo
禄	llv;
郎	llvu
朗	llvv
羚	lm/v
遴	lm;v
燎	lmao
炼	lmav
娄	lmva
炉	lmve
粼	lmvv
熘	lmzo
寥	ln/e
寮	lnao
愣	lno;
窿	lnvz
蛉	lo/;
髅	lo/v
嶙	lo/z
睐	lo;;
詈	lo;o
瞭	loao
崂	loez
螺	loov
螂	lovv
岚	loz/
赂	lozo
辚	ls/z
轳	lsua
篓	lt/v
笠	lt;a
梨	ltau
籁	ltaz
黧	lto;
箓	ltva
氯	ltvu
坜	luaz
陇	lva;
陋	lvav
胪	lvua
陵	lvuz
肋	lvzz
遛	lw;v
鲢	lwa;
鲡	lwao
雒	lwe;
猁	lweu
鲤	lwoa
鲁	lwoo
狸	lwou
猡	lwoz
卵	lwv;
纶	lx/z
骊	lxao
绫	lxuz
驴	lxve
骆	lxzo
锊	ly/a
铃	ly/v
镭	ly;o
镣	lyao
镏	lye;
卤	lyo/
镧	lyo;
锂	lyoa
铝	lyoo
锒	lyv;
鸬	lyza
枚	mcea
棉	mceu
懋	mcv;
湎	mdao
漭	mdea
濛	mdeu
汨	mdoa
渑	mdoo
渺	mdou
淼	mduu
溟	mdv;
泯	mdva
湄	mdvo
蘑	me;a
芒	me;v
蔑	mea;
莽	meaa
暮	meao
墓	meau
莓	meea
苗	meoa
蔓	meoo
幕	meou
萌	meov
慕	meu;
茉	meuo
蓦	meva
茗	mezo
髦	mfev
瑁	mgoo
珉	mgva
麋	mh/;
霾	mh/o
霉	mhea
瘼	mheo
魔	mheu
麽	mhev
蛮	mho;
亩	mhoa
盲	mhoo
袤	mhve
邙	mhvu
哞	miv;
抿	mkva
牟	mlea
谟	mleo
蝥	mlo;
幂	mloa
谩	mloo
谬	mlv/
袂	mlva
谧	mlvo
邈	mm;v
貘	mmeo
觅	mmoe
熳	mmoo
焖	mmov
懵	mneo
悯	mno;
密	mnou
宓	mnv;
寐	mnvu
皿	moaa
蟒	moea
瞄	moeo
蠓	moeu
帽	mooo
幔	moov
眇	moue
睦	mouu
瞑	mov;
蜢	mova
岷	mova
眸	move
嵋	movo
蚂	movv
魅	mru;
暝	mrvo
嬷	ms;a
嫫	mseo
妙	msue
姆	msv;
牧	mtea
穆	mteu
秣	mtu;
牡	mtuu
秘	mtv;
朦	mveu
孟	mvoo
馍	mweo
贸	mwo/
馒	mwoo
鳗	mwov
猕	mwva
卯	mwvu
乜	mxvv
孬	navv
溺	ndv;
泥	ndvz
聂	nfvv
耨	ngau
旎	nhea
蹑	niau
啮	niua
哝	niv;
呶	nive
恁	njv;
傩	njve
侬	njvo
伲	njvz
捺	nkau
撵	nkua
搦	nkv;
扭	nkva
挪	nkvv
衲	nlo;
糯	nm;a
懦	nn;a
怩	nnva
奴	nsv;
弩	nsva
妞	nsvu
娜	nsvv
妮	nsvz
妳	nszu
奶	nszz
黏	ntua
狞	nw;a
馕	nwau
猊	nweu
狃	nwvu
铙	nyav
钕	nyve
殍	pa/v
砒	paav
邳	pavv
譬	pb;o
溥	pda;
浦	pdau
濮	pdeu
泡	pdzv
蒲	pe;a
菩	pe;o
苹	pe;u
苤	peaa
莆	peau
剽	pfuu
霈	ph;;
痞	phao
疱	phzv
叭	pi//
呸	piaa
哌	piee
噗	piu/
嘭	piue
蹁	pivo
咆	pizv
凭	pjzz
扒	pk//
撇	pk/e
抨	pk;u
撇	pkue
捧	pkuu
披	pkzv
翩	plvv
粕	pmeo
盆	pmoa
瞥	pmoo
蟠	po/o
螃	po;;
瞟	poau
毗	poav
蜱	poeu
乓	pr;;
魄	preu
娉	psoa
牝	ptzv
坯	puaa
胼	pv/u
脬	pv/v
膀	pv;;
胚	pvaa
爿	pvee
纰	pxav
槭	qca;
栖	qcau
楸	qce/
樵	qce;
橇	qcea
榷	qcve
淇	qda/
渠	qdau
沏	qdav
汔	qdea
泅	qdo/
潜	qduo
芩	qe/v
萋	qeav
颧	qee/
荞	qeea
芹	qeee
芊	qeeu
荨	qeva
芪	qezv
鬈	qf/v
逑	qf;v
醛	qfe/
蛩	qfo;
綦	qfvu
欺	qfz/
鹊	qfza
契	qga;
琦	qgaa
契	qgao
琪	qgau
麒	qha/
弃	qhau
凄	qhav
旗	qhea
噙	qi/;
跄	qi/v
嘁	qiau
佥	qja;
俅	qjau
戗	qjav
仟	qjea
倩	qjuo
劁	qjuu
俏	qjuv
俟	qjve
揿	qkea
诠	ql/u
巯	ql;e
逡	ql;v
讫	qlea
诮	qluv
祁	qlvu
诎	qlvv
糗	qmeu
羟	qmva
郄	qmvv
券	qmzz
惬	qna;
窍	qnau
愀	qnea
褰	qnu;
搴	qnue
悭	qnuu
怯	qnuv
骞	qnva
囚	qo/;
蜣	qo/u
黔	qo/v
髂	qo;z
嵌	qoau
岖	qoav
蛆	qooa
岐	qou;
畦	qouu
蜻	qouv
虬	qovv
黢	qovz
躯	qra/
辁	qs/u
嫱	qsuo
翘	qsvv
签	qt/a
筌	qt/u
迄	qt;v
箝	qtau
筇	qtav
箐	qtuo
憩	qtv;
氢	qtva
乞	qtvv
磬	quao
脐	qv;e
绮	qxaa
锵	qy;z
锹	qye/
钎	qyea
龋	qyeo
锲	qyua
铅	qyzo
濡	rd;a
沤	rda/
溽	rdaa
洱	rdau
蔼	re;o
茸	reau
苒	reoa
萼	reou
蕊	rev;
茹	revo
髯	rfoa
鞣	rfva
遨	rg;v
珥	rgau
螯	rgo;
耦	rgoo
鳌	rgza
瓤	rhee
嗌	ri/o
嗳	ri/v
嚅	ri;a
唔	riao
呃	riav
哎	rie/
颚	rie;
噢	rieu
蹂	riva
鄂	rivu
俺	rjao
偌	rjea
仁	rjua
闰	rjuu
攘	rk;a
挠	rkaa
捱	rkau
扼	rkav
揉	rkva
拗	rkvv
褥	rlau
讴	rlav
冗	rlee
讹	rleu
糅	rmva
懊	rneu
愕	rnou
蠕	ro;a
冉	roa;
凹	roaa
蛾	roea
蚋	roo;
遏	rr;v
娆	rsav
妊	rsea
媪	rsoo
轫	rsz;
鸥	rsza
殴	rszv
胺	rv;v
狨	rwaa
饵	rwau
饪	rweu
缛	rxaa
锷	ryou
戍	sa;;
厮	saau
硕	sae/
殇	saea
蜃	sao;
盛	saoa
豕	saoo
砷	saou
砂	saue
卅	sauu
属	sbeo
栓	sc/u
梳	sc;e
柿	sc;o
枢	sca/
椹	scau
枢	scav
虱	sceo
梭	scv/
淞	sda/
沭	sda;
涑	sdao
漱	sdau
潸	sdav
挲	sdea
溲	sdeu
泗	sdoa
汕	sdou
涉	sduu
淑	sduv
渗	sdve
涮	sdvu
汜	sdvv
鲨	sdzo
蓑	se;o
莘	se;u
苫	seuo
菽	seuv
蔬	sev;
荪	sevu
芍	sez;
苕	sezo
芟	sezv
粟	sf/o
酥	sfea
斯	sfee
啬	sfoo
丧	sfu;
丧	sfv;
肆	sfvu
琐	sguo
瑟	sgv;
庶	sh;;
痧	sh;u
霎	sh;v
竦	shau
庶	she;
霰	shee
麝	sheu
衰	shoe
疝	shoo
塾	shuu
癖	shv;
瘆	shve
瘙	shvo
煽	shvv
飒	shz/
韶	shzo
嗽	siau
嗖	sieu
嗜	siuo
嗦	siuv
唆	siv/
咝	siva
吮	sive
嗣	sivo
唰	sivu
俗	sj//
僧	sj/o
伞	sj/u
裳	sj;;
闩	sjaa
傻	sjeo
赏	sjo/
裳	sjo;
售	sjoo
伸	sjou
佘	sju;
侍	sjua
舍	sjuo
隼	sjuu
怂	sjv;
伺	sjva
俞	sjvu
舒	sjvv
擞	sk/e
拾	sk/o
拴	sk/u
擅	sk;o
摔	sk;u
逝	sk;v
撕	skau
拭	skav
撒	skee
搡	skva
搔	skvo
抒	skvv
谥	sl/o
讼	sl/v
桑	slau
衫	slee
讪	sloo
谡	sloz
叁	slua
圣	sluu
诵	slv;
祀	slva
诵	slvo
扇	slvv
熵	sm;o
遂	sm;v
弑	sma;
槊	smau
烧	smav
颂	sme/
兽	smoo
刹	smuu
糁	smve
鄯	smvu
朔	smvv
舜	smza
忪	sn/v
窣	sn;u
悚	snao
宋	snau
慑	snav
恃	snua
慎	snuo
塞	snuu
愫	snuv
蟮	so/o
赊	so/u
嵩	so;o
蟀	so;u
崧	soau
睢	soe;
赎	sou;
蛳	soue
署	souo
墅	souu
赡	soz;
蜀	sozo
艄	sqev
晟	sra;
晒	srau
叟	srv;
孀	ss;a
嬗	ss;o
姝	ssea
恕	ssv;
黍	st/u
矢	st;;
筮	sta/
秫	sta;
簌	stau
笙	stea
筲	stev
舌	stoo
甥	stoz
筛	stua
穑	stuo
剩	stuu
稍	stuv
笋	stve
歃	stz/
膳	sv/o
腧	sv/v
膻	sv;a
疏	sv;e
陕	sv;o
胜	sveu
臊	svoa
祟	svuu
飧	sw/v
勺	sw;;
狩	sw;a
觞	swea
馓	swee
稣	sweo
飕	sweu
馊	swev
鳃	swov
删	swuu
殳	swv;
饲	swvo
狲	swvu
甩	swvv
绶	sx/v
驷	sxoa
绳	sxoo
绅	sxou
纾	sxv;
缫	sxvo
骟	sxvv
鸶	sxza
铄	syzu
殄	ta/e
套	taau
榻	tcov
椭	tcva
烫	td//
滔	td/e
涕	td/v
溏	td;v
沱	td;z
汰	tda;
汀	tdau
溻	tdov
淌	tduo
澹	tdz;
淘	tdze
苔	tevo
菟	tezo
醣	tf;v
醍	tfoa
瑭	tg;v
吞	tgoo
霆	thev
瘫	thv;
饕	ti/v
蹄	ti;o
跎	ti;z
蹋	tiov
踏	tiuo
蹚	tiuu
嚏	tiuv
嗵	tiv;
跆	tivo
趿	tiz;
僮	tj;o
途	tj;v
佗	tj;z
棠	tjoa
傥	tjue
氽	tjuu
倜	tjzu
搪	tk;v
挞	tka;
拓	tkao
挺	tkea
拖	tkev
摊	tkv;
探	tkva
捅	tkvo
掏	tkze
谭	tlau
邰	tlvu
煺	tmv;
烃	tmva
郯	tmvu
窕	tnz;
蜕	to/z
疃	to;o
炭	toa/
凸	toaa
町	toau
囤	toav
畋	toea
螳	toeo
帖	touo
骰	tozv
剔	truu
昙	truv
忒	tsv;
笤	ttzo
坨	tu;z
塌	tuov
填	tuuo
坛	tuuv
粜	tv/;
滕	tv/u
陀	tv;z
肽	tva;
腆	tvo/
逖	tw;v
钽	tyoa
杌	wcav
汶	wd;/
豌	wd;z
渭	wdov
洼	wduu
潍	wdvv
莞	we;u
萎	weev
芜	weuv
琬	wg;z
玮	wguu
雯	wh;/
痦	whau
忘	whv;
弯	whva
妄	whvv
吴	wiu;
哇	wiuu
呜	wiza
伍	wjau
佤	wjav
倭	wjea
仵	wjeu
讳	wluu
婺	wlva
焐	wmau
忤	wnea
惘	wno/
愠	wnoo
怃	wnuv
崴	woav
帷	woe;
嵬	woev
蛙	wouu
帏	wouv
幄	wovu
韪	wruu
婉	ws;z
妩	wsuv
舞	wtz;
圬	wuuv
脘	wv;u
鲔	wwav
猬	wwov
邬	wwvu
绾	wx;v
戌	xaa;
咸	xaao
硒	xaau
咸	xao;
矽	xaz;
弦	xb;;
遐	xb;v
巽	xbe/
迅	xc;v
栖	xcau
朽	xcav
檄	xcee
皙	xceo
榭	xceu
樨	xcvu
淆	xd/a
汹	xd/v
漩	xd;e
泫	xd;v
淅	xdae
泄	xdav
潇	xde;
溴	xdeo
涎	xdeu
泄	xdev
沁	xdv;
浔	xdva
汛	xdvu
汐	xdz;
萱	xe;a
薪	xe;e
薰	xee;
芯	xev;
醺	xfe;
靴	xfez
昔	xfoo
巷	xfvv
瑄	xg;a
刑	xguu
瑕	xgvv
痃	xh;v
亵	xhe;
冼	xhea
襄	xhee
席	xheo
庥	xheu
旋	xhev
痫	xhoa
畜	xhoo
襄	xhue
霄	xhuv
玄	xhv;
畜	xhvo
享	xhvu
霞	xhvv
嚣	xiao
跣	xiea
兄	xiee
嗅	xieo
咻	xieu
呷	xiou
嘻	xiuo
嘘	xiuu
哮	xiuv
勋	xizz
侠	xj;;
闲	xjau
偕	xjav
肖	xjvv
掀	xkee
擤	xkeo
衔	xkeu
携	xkez
撷	xkue
祥	xl/u
熊	xl;;
戏	xla;
谐	xlav
训	xleu
裼	xloz
谑	xlua
禧	xluo
诩	xlvv
煊	xm;a
炫	xm;v
奚	xma;
羲	xmea
悉	xmv;
羞	xmva
郗	xmvu
翔	xmvv
宪	xnea
忻	xnee
恤	xneo
悻	xnu/
窸	xnv;
恂	xnzo
崤	xo/a
瞎	xo;u
眩	xo;v
岫	xoou
悬	xov;
蟓	xozo
勖	xozz
歆	xqz/
晞	xr/a
曦	xr/e
煦	xr;;
晰	xrae
曛	xre;
昕	xree
晌	xreo
魈	xruv
媳	xseu
娴	xsoa
嬉	xsuo
絮	xsvu
婿	xsvv
熏	xt;;
筱	xteu
氙	xtoo
箫	xtv;
埙	xuoo
腺	xveu
胥	xvvv
胁	xvz;
降	xvza
陷	xvze
鳕	xw;;
狭	xw;o
蟹	xwo;
猩	xwoe
旭	xwoo
狎	xwou
郇	xwvv
骧	xx;o
纤	xxea
驯	xxeu
绣	xxez
绪	xxuo
绡	xxuv
锌	xy;u
铉	xy;v
锨	xyee
铣	xyeu
虚	xyua
厌	yaa;
靥	yaaa
雁	yae;
赝	yaeo
魇	yaev
殃	yao;
砚	yaoe
殒	yaoo
奄	yaov
压	yau;
尢	yav;
郁	yavv
椰	ycau
杳	ycoo
柚	ycou
橼	ycvv
檐	ycz;
楹	yczo
浴	yd//
漾	yd/;
淫	yd/e
溢	yd/o
渝	yd/v
淤	yd;/
夷	yd;;
液	yd;e
瀛	yd;v
淹	ydao
涯	ydau
沂	ydee
滢	ydeu
潆	ydev
泱	ydo;
洇	ydoa
滟	yduz
涌	ydvo
漪	ydza
渔	ydzo
薏	ye;v
莜	yeeu
萤	yeo;
茵	yeoa
茔	yeua
芋	yeuu
芸	yeuv
蕴	yevo
萦	yevu
荫	yevv
药	yevz
莺	yeza
苑	yezv
焉	yfa;
酉	yfaa
颐	yfe/
鞅	yfo;
鄢	yfvv
琰	yg//
瑜	yg/v
瑛	ygeo
膺	ygev
盂	ygoa
韫	ygoo
璎	ygov
玥	ygvv
於	yh/;
瘀	yh;/
霪	yh;e
疣	yha;
奕	yhaa
痍	yhav
颜	yhe/
彦	yhee
庾	yheu
鹰	yhez
裔	yho/
赢	yhov
雍	yhv;
兖	yhve
冶	yhvo
庸	yhvu
翊	yhvv
瘾	yhvz
疫	yhz;
鹰	yhza
疡	yhze
毅	yhzv
喻	yi/v
噫	yi;o
唷	yi;v
哑	yiau
咦	yiav
咿	yieu
呓	yiev
咽	yioa
喁	yioo
嘤	yiov
噎	yiua
吆	yiv;
踊	yivo
邑	yivv
哟	yivz
仪	yj/;
佯	yj/u
阏	yj;/
逾	yj;v
倚	yjaa
佑	yjao
俨	yjau
偃	yjav
佚	yjea
闫	yjua
悠	yjv;
伊	yjva
耀	yjve
俑	yjvo
亿	yjvv
阎	yjze
佣	yjzu
徭	yk/e
徉	yk/u
援	yk/v
掖	yk;e
喑	yk;o
唁	yk;u
衙	ykau
揖	ykoa
役	ykz;
拥	ykzu
抑	ykzv
裕	yl//
谣	yl/e
裕	yl/o
谕	yl/v
翌	yl;a
谚	yl;e
谊	yl;o
祐	ylao
羿	ylau
矣	yle;
诱	ylea
允	ylee
谀	yleu
甬	ylou
恿	ylov
谒	yloz
刭	yluu
羽	ylv;
诒	ylvo
郓	ylvv
冤	ylz;
鹬	ylza
豫	ylze
诣	ylzo
爻	ym//
焱	ym/;
烊	ym/u
舀	ymeu
煜	ymo;
丫	ymuu
恙	ymv;
熠	ymve
鹞	ymza
焰	ymze
愉	yn/v
慵	yn;v
寅	yna/
恹	ynaa
宥	ynav
怏	yno;
寓	ynoo
宴	ynov
恽	ynva
怡	ynvo
峪	yo/o
央	yo;;
遗	yo;v
螈	yoae
岩	yoao
崖	yoau
屿	yoav
罂	yoea
曳	yoee
蜒	yoeu
禺	yoo;
蝇	yooo
蜴	yooz
愚	yov;
蚓	yova
婴	yove
贻	yovo
邮	yovu
幽	yovv
黝	yovz
鹦	yoza
禹	yr;;
昱	yr;a
晏	yr;v
曰	yraa
粤	yrav
晔	yreu
鼹	yro;
臾	yroo
岳	yrou
劓	yruu
媛	ys/v
弋	ys;;
迓	ys;v
妪	ysa/
嫣	ysa;
娅	ysau
尧	ysav
轶	yse;
妖	ysea
牙	ysee
彧	yso;
娱	ysou
辕	ysuo
妤	ysvv
欤	ysz/
鸢	ysza
毓	yt;e
迤	yt;v
墉	yu;v
壹	yua/
域	yua;
垣	yuao
堙	yuau
堰	yuav
盐	yuoa
邺	yuvv
腋	yv;e
臆	yv;o
臃	yv;v
腌	yvao
胰	yvav
隅	yvo;
胭	yvoa
陨	yvoo
匀	yw;a
逸	yw;v
鱿	ywa;
颍	ywe/
怨	ywv;
狱	ywva
饴	ywvo
肄	ywvu
疑	ywvv
缢	yx/o
彝	yxau
邕	yxov
驿	yxv;
绎	yxvu
驭	yxvv
龉	yyau
铘	yyav
铀	yyoa
玻璃	bgz
嫦娥	csu
玳瑁	dge
玷污	dgu
吩咐	fi/
疙瘩	ghe
旮旯	gzo
诙谐	hla
蛤蟆	ho/
蝴蝶	hou
囫囵	hoz
鹧鸪	ihz
觊觎	joo
咖啡	kiz
傀儡	kje
篱笆	lt;
垃圾	lu;
趔趄	lua
邋遢	lx;
忸怩	nnv
琵琶	pga
彷徨	pk;
缥缈	pxa
蛐蛐	qoo
鹌鹑	raz
峨嵋	roe
婀娜	rsv
忐忑	tyv
龌龊	wyv
唏嘘	xi/
羡慕	xm;
蟋蟀	xo/
蜥蜴	xoa
卜	bj;;;
钵	byau;
噌	ci/o;
踹	cioa;
跶	dia;;
蛄	gouo;
秆	gtuu;
鸹	gtza;
喉	hiev;
痔	ihua;
踵	iiea;
蜇	iko;;
祚	ileu;
蛀	io;a;
嶂	io;o;
幛	io;u;
锃	iyou;
钊	iyuu;
暨	jboa;
豇	jdau;
醮	jfe;;
刳	kauu;
瘘	lh/v;
冽	lhau;
膂	lhva;
娈	lhve;
偻	lj/v;
镂	ly/v;
檬	mcea;
苜	meou;
螨	moea;
蟆	moeo;
螟	movo;
驽	nsvv;
庖	phzv;
蹼	piu/;
蜷	qo/v;
哂	siau;
仕	sjua;
绥	sx/v;
序	xhv;;
湮	ydau;
胤	yevv;
嬴	yhov;
呦	yivz;
阉	yjao;
烨	ymeu;
炀	ymze;
愠	ynoo;
蜮	yoav;
蛹	yovo;
鸯	yoza;
驿	yxvu;
鹁鸪	bfza
蝙蝠	bovo
璀璨	cgoe
痤疮	ch/u
蹉跎	ci/a
踟躇	ciea
徜徉	ckuo
憧憬	cn;o
惭愧	cnav
惆怅	cnzu
蟾蜍	coz;
伧促	cr/v
喋喋	diea
咄咄	divu
诽谤	flua
尴尬	gauo
橄榄	gcve
蝈蝈	goou
旮旯	gwoo
斟酌	ifu;
踯躅	ii/v
蟑螂	io;o
蜘蛛	ioeo
狰狞	iwzv
矍铄	jov;
孑孓	jva;
袈裟	jz;e
咳嗽	ki;;
崆峒	ko;a
蝌蚪	koe;
萝卜	leoz
囹圄	lo/v
耄耋	mfea
腼腆	mvao
磅礴	pa;;
滂沱	pd;;
葡萄	peza
嘌呤	piau
蹒跚	piea
徘徊	pkua
乒乓	pree
蹊跷	qi/a
襁褓	qlvo
崎岖	qoaa
蚯蚓	qoeu
肮脏	rv;z
呻吟	siou
唢呐	siu/
蜿蜒	wo;z
蜈蚣	woou
逶迤	wt;v
逍遥	xj;v
螅蟀	xoeo
牺牲	xtau
邂逅	xw;v
旖旎	yhea
揶揄	ykav
窈窕	ynvz
氤氲	ytoa
鸳鸯	ywza
钥匙	yyvv
踌躇	ciua;
佝偻	gjzo;
峥嵘	iozv;
妯娌	isoa;
吝啬	lhoo;
蝼蚁	lo/v;
不	ba;;
有	yava
一	ydaa
半	bmu
办	bz;
程	cto
等	dtu
复	fto
公	gmv
果	go;
告	gto
化	hjz
黑	ho;
或	hso
展	ibe
真	if/
早	iru
怎	itv
极	jcz
交	jh/
军	jla
精	jmu
乐	lw;
母	mx;
呢	niv
拿	njo
能	nlz
其	qf/
七	qsa
切	qsz
却	quv
让	rlu
入	rm/
容	rno
如	rso
师	spa
少	spe
谈	tl/
通	tl;
调	tlz
它	tnz
图	toz
无	wgv
现	xgo
学	xnv
笑	xte
影	yre
变	bhvv
吧	bivv
报	bkvv
必	blee
备	bwoo
步	byee
存	cava
产	chee
常	cjoo
传	cju;
曾	cmoa
场	cuzz
带	dfou
底	dhz;
代	djav
但	djoo
得	dkoa
调	dlzu
断	dmee
单	dmou
东	ds;;
第	dtvv
方	fhvv
格	gcz;
更	gf;;
过	gf;v
古	gfoa
功	gfzz
高	ghoo
刚	gouu
何	hjao
合	hjoo
候	hjva
乎	hmuu
再	ifaa
整	ifaa
者	ifoa
直	ifoa
装	ih;;
主	ihaa
站	ihuo
住	ij;a
做	ijue
找	ikav
之	ilvv
着	imoo
最	irav
转	isu;
终	ixz;
己	jbvv
教	jfea
就	jhav
将	jhz;
间	jjoo
据	jkvu
计	jluu
家	jna;
举	jnuu
具	jo//
几	jwvv
解	jwze
结	jxuo
可	kfoo
哭	kia;
看	kkoo
客	knzo
老	lfzz
离	lhov
满	mde;
命	mjov
求	qf;;
期	qfvv
前	qmvu
千	qtuu
任	rjea
然	rw;;
深	sdv/
十	sfuu
诉	slee
神	slou
受	smvv
四	soev
身	sree
算	stoa
特	ttuu
王	wgaa
望	whua
问	wjoo
外	wwu;
信	xj;o
心	xl;;
写	xlav
兴	xn//
息	xrv;
引	ybuu
远	yg;v
应	yh;a
音	yhoo
意	yhov
语	ylao
义	ym;;
由	yoaa
月	yvvv
乐	yw;;
团	toau;
春	cgoo
旱	hruu
忽	hwv;
嘴	iiuz
略	lozo
识	slo/
腿	tvv;
汪	wdua
